District Name,District No,Jilha,Constituency Name,Constituency No,Total No. of Electors,Serial Poll,Total No. Valid Votes,No. of Rejected Votes,NOTA,Total,No. of Tendered Votes,Elected Person Name,Party Name of Elected Person,No. of Valid Votes Cast in Favour of Elected Person,Other Candidate Votes,Total EVM Votes,Total Postal ballot votes,Total Votes Polled
Mumbai Suburban,,,Anushakti Nagar,172,,1,8,604,0,612,0,RAJNAS DAZA AYILA,,203,990,1193,0,1193
Mumbai Suburban,,,Anushakti Nagar,172,,2,5,459,0,464,0,RAJNAS DAZA AYILA,,160,750,910,0,910
Mumbai Suburban,,,Anushakti Nagar,172,,3,14,573,0,587,0,RAJNAS DAZA AYILA,,256,865,1121,0,1121
Mumbai Suburban,,,Anushakti Nagar,172,,4,10,434,0,444,0,RAJNAS DAZA AYILA,,188,664,852,0,852
Mumbai Suburban,,,Anushakti Nagar,172,,5,7,577,0,584,0,RAJNAS DAZA AYILA,,133,1012,1145,0,1145
Mumbai Suburban,,,Anushakti Nagar,172,,6,3,603,0,606,0,RAJNAS DAZA AYILA,,163,1043,1206,0,1206
Mumbai Suburban,,,Anushakti Nagar,172,,7,7,490,0,497,0,RAJNAS DAZA AYILA,,143,830,973,0,973
Mumbai Suburban,,,Anushakti Nagar,172,,8,20,614,0,634,0,RAJNAS DAZA AYILA,,169,1027,1196,0,1196
Mumbai Suburban,,,Anushakti Nagar,172,,9,10,665,0,675,0,RAJNAS DAZA AYILA,,127,1192,1319,0,1319
Mumbai Suburban,,,Anushakti Nagar,172,,10,14,488,0,502,0,RAJNAS DAZA AYILA,,172,786,958,0,958
Mumbai Suburban,,,Anushakti Nagar,172,,11,9,567,0,576,0,RAJNAS DAZA AYILA,,126,1001,1127,0,1127
Mumbai Suburban,,,Anushakti Nagar,172,,12,13,618,0,631,0,RAJNAS DAZA AYILA,,165,1057,1222,0,1222
Mumbai Suburban,,,Anushakti Nagar,172,,13,11,678,0,689,0,RAJNAS DAZA AYILA,,164,1183,1347,0,1347
Mumbai Suburban,,,Anushakti Nagar,172,,14,5,452,0,457,0,RAJNAS DAZA AYILA,,118,790,908,0,908
Mumbai Suburban,,,Anushakti Nagar,172,,15,4,556,0,560,0,RAJNAS DAZA AYILA,,217,902,1119,0,1119
Mumbai Suburban,,,Anushakti Nagar,172,,16,8,458,0,466,0,RAJNAS DAZA AYILA,,136,780,916,0,916
Mumbai Suburban,,,Anushakti Nagar,172,,17,3,684,0,687,0,RAJNAS DAZA AYILA,,201,1178,1379,0,1379
Mumbai Suburban,,,Anushakti Nagar,172,,18,6,701,0,707,0,RAJNAS DAZA AYILA,,200,1208,1408,0,1408
Mumbai Suburban,,,Anushakti Nagar,172,,19,4,465,0,469,0,RAJNAS DAZA AYILA,,93,848,941,0,941
Mumbai Suburban,,,Anushakti Nagar,172,,20,5,500,0,505,0,RAJNAS DAZA AYILA,,159,851,1010,0,1010
Mumbai Suburban,,,Anushakti Nagar,172,,21,16,683,0,699,0,RAJNAS DAZA AYILA,,103,1252,1355,0,1355
Mumbai Suburban,,,Anushakti Nagar,172,,22,7,295,0,302,0,RAJNAS DAZA AYILA,,79,519,598,0,598
Mumbai Suburban,,,Anushakti Nagar,172,,23,10,440,0,450,0,RAJNAS DAZA AYILA,,118,765,883,0,883
Mumbai Suburban,,,Anushakti Nagar,172,,24,11,744,0,755,0,RAJNAS DAZA AYILA,,236,1254,1490,0,1490
Mumbai Suburban,,,Anushakti Nagar,172,,25,10,493,0,503,0,RAJNAS DAZA AYILA,,116,875,991,0,991
Mumbai Suburban,,,Anushakti Nagar,172,,26,10,586,0,596,0,RAJNAS DAZA AYILA,,175,1003,1178,0,1178
Mumbai Suburban,,,Anushakti Nagar,172,,27,9,569,0,578,0,RAJNAS DAZA AYILA,,90,1057,1147,0,1147
Mumbai Suburban,,,Anushakti Nagar,172,,28,18,611,0,629,0,RAJNAS DAZA AYILA,,135,1079,1214,0,1214
Mumbai Suburban,,,Anushakti Nagar,172,,29,4,419,0,423,0,RAJNAS DAZA AYILA,,165,694,859,0,859
Mumbai Suburban,,,Anushakti Nagar,172,,30,17,666,0,683,0,RAJNAS DAZA AYILA,,205,1123,1328,0,1328
Mumbai Suburban,,,Anushakti Nagar,172,,31,20,653,0,673,0,RAJNAS DAZA AYILA,,249,1048,1297,0,1297
Mumbai Suburban,,,Anushakti Nagar,172,,32,25,637,0,662,0,RAJNAS DAZA AYILA,,195,1061,1256,0,1256
Mumbai Suburban,,,Anushakti Nagar,172,,33,17,661,0,678,0,RAJNAS DAZA AYILA,,179,1142,1321,0,1321
Mumbai Suburban,,,Anushakti Nagar,172,,34,19,598,0,617,0,RAJNAS DAZA AYILA,,175,1017,1192,0,1192
Mumbai Suburban,,,Anushakti Nagar,172,,35,18,544,0,562,0,RAJNAS DAZA AYILA,,176,911,1087,0,1087
Mumbai Suburban,,,Anushakti Nagar,172,,36,12,549,0,561,0,RAJNAS DAZA AYILA,,134,976,1110,0,1110
Mumbai Suburban,,,Anushakti Nagar,172,,37,14,504,0,518,0,RAJNAS DAZA AYILA,,189,828,1017,0,1017
Mumbai Suburban,,,Anushakti Nagar,172,,38,9,513,0,522,0,RAJNAS DAZA AYILA,,187,859,1046,0,1046
Mumbai Suburban,,,Anushakti Nagar,172,,39,11,528,0,539,0,RAJNAS DAZA AYILA,,137,936,1073,0,1073
Mumbai Suburban,,,Anushakti Nagar,172,,40,4,300,0,304,0,RAJNAS DAZA AYILA,,89,543,632,0,632
Mumbai Suburban,,,Anushakti Nagar,172,,41,6,367,0,373,0,RAJNAS DAZA AYILA,,179,584,763,0,763
Mumbai Suburban,,,Anushakti Nagar,172,,42,10,388,0,398,0,RAJNAS DAZA AYILA,,115,683,798,0,798
Mumbai Suburban,,,Anushakti Nagar,172,,43,10,571,0,581,0,RAJNAS DAZA AYILA,,208,957,1165,0,1165
Mumbai Suburban,,,Anushakti Nagar,172,,44,5,497,0,502,0,RAJNAS DAZA AYILA,,240,788,1028,0,1028
Mumbai Suburban,,,Anushakti Nagar,172,,45,6,750,0,756,0,RAJNAS DAZA AYILA,,462,1071,1533,0,1533
Mumbai Suburban,,,Anushakti Nagar,172,,46,17,672,0,689,0,RAJNAS DAZA AYILA,,389,967,1356,0,1356
Mumbai Suburban,,,Anushakti Nagar,172,,47,26,786,0,812,0,RAJNAS DAZA AYILA,,288,1279,1567,0,1567
Mumbai Suburban,,,Anushakti Nagar,172,,48,24,591,0,615,0,RAJNAS DAZA AYILA,,214,968,1182,0,1182
Mumbai Suburban,,,Anushakti Nagar,172,,49,53,664,0,717,0,RAJNAS DAZA AYILA,,203,1068,1271,0,1271
Mumbai Suburban,,,Anushakti Nagar,172,,50,41,788,0,829,0,RAJNAS DAZA AYILA,,420,1124,1544,0,1544
Mumbai Suburban,,,Anushakti Nagar,172,,51,44,912,0,956,0,RAJNAS DAZA AYILA,,287,1500,1787,0,1787
Mumbai Suburban,,,Anushakti Nagar,172,,52,15,262,0,277,0,RAJNAS DAZA AYILA,,93,453,546,0,546
Mumbai Suburban,,,Anushakti Nagar,172,,53,18,359,0,377,0,RAJNAS DAZA AYILA,,161,574,735,0,735
Mumbai Suburban,,,Anushakti Nagar,172,,54,65,743,0,808,0,RAJNAS DAZA AYILA,,275,1135,1410,0,1410
Mumbai Suburban,,,Anushakti Nagar,172,,55,30,736,0,766,0,RAJNAS DAZA AYILA,,355,1112,1467,0,1467
Mumbai Suburban,,,Anushakti Nagar,172,,56,18,652,0,670,0,RAJNAS DAZA AYILA,,330,994,1324,0,1324
Mumbai Suburban,,,Anushakti Nagar,172,,57,18,853,0,871,0,RAJNAS DAZA AYILA,,392,1335,1727,0,1727
Mumbai Suburban,,,Anushakti Nagar,172,,58,12,710,0,722,0,RAJNAS DAZA AYILA,,338,1116,1454,0,1454
Mumbai Suburban,,,Anushakti Nagar,172,,59,26,887,0,913,0,RAJNAS DAZA AYILA,,452,1329,1781,0,1781
Mumbai Suburban,,,Anushakti Nagar,172,,60,18,647,0,665,0,RAJNAS DAZA AYILA,,347,971,1318,0,1318
Mumbai Suburban,,,Anushakti Nagar,172,,61,40,664,0,704,0,RAJNAS DAZA AYILA,,262,1047,1309,0,1309
Mumbai Suburban,,,Anushakti Nagar,172,,62,66,727,0,793,0,RAJNAS DAZA AYILA,,323,1061,1384,0,1384
Mumbai Suburban,,,Anushakti Nagar,172,,63,16,570,0,586,0,RAJNAS DAZA AYILA,,370,801,1171,0,1171
Mumbai Suburban,,,Anushakti Nagar,172,,64,49,604,0,653,0,RAJNAS DAZA AYILA,,234,940,1174,0,1174
Mumbai Suburban,,,Anushakti Nagar,172,,65,7,589,0,596,0,RAJNAS DAZA AYILA,,235,994,1229,0,1229
Mumbai Suburban,,,Anushakti Nagar,172,,66,11,568,0,579,0,RAJNAS DAZA AYILA,,206,974,1180,0,1180
Mumbai Suburban,,,Anushakti Nagar,172,,67,8,505,0,513,0,RAJNAS DAZA AYILA,,197,864,1061,0,1061
Mumbai Suburban,,,Anushakti Nagar,172,,68,27,347,0,374,0,RAJNAS DAZA AYILA,,101,607,708,0,708
Mumbai Suburban,,,Anushakti Nagar,172,,69,7,396,0,403,0,RAJNAS DAZA AYILA,,192,655,847,0,847
Mumbai Suburban,,,Anushakti Nagar,172,,70,8,470,0,478,0,RAJNAS DAZA AYILA,,281,713,994,0,994
Mumbai Suburban,,,Anushakti Nagar,172,,71,9,552,0,561,0,RAJNAS DAZA AYILA,,360,797,1157,0,1157
Mumbai Suburban,,,Anushakti Nagar,172,,72,17,655,0,672,0,RAJNAS DAZA AYILA,,350,998,1348,0,1348
Mumbai Suburban,,,Anushakti Nagar,172,,73,11,512,0,523,0,RAJNAS DAZA AYILA,,242,833,1075,0,1075
Mumbai Suburban,,,Anushakti Nagar,172,,74,11,423,0,434,0,RAJNAS DAZA AYILA,,230,668,898,0,898
Mumbai Suburban,,,Anushakti Nagar,172,,75,3,521,0,524,0,RAJNAS DAZA AYILA,,109,1002,1111,0,1111
Mumbai Suburban,,,Anushakti Nagar,172,,76,4,602,0,606,0,RAJNAS DAZA AYILA,,165,1107,1272,0,1272
Mumbai Suburban,,,Anushakti Nagar,172,,77,3,609,0,612,0,RAJNAS DAZA AYILA,,212,1077,1289,0,1289
Mumbai Suburban,,,Anushakti Nagar,172,,78,2,553,0,555,0,RAJNAS DAZA AYILA,,117,1063,1180,0,1180
Mumbai Suburban,,,Anushakti Nagar,172,,79,3,364,0,367,0,RAJNAS DAZA AYILA,,78,723,801,0,801
Mumbai Suburban,,,Anushakti Nagar,172,,80,6,603,0,609,0,RAJNAS DAZA AYILA,,168,1106,1274,0,1274
Mumbai Suburban,,,Anushakti Nagar,172,,81,5,515,0,520,0,RAJNAS DAZA AYILA,,133,968,1101,0,1101
Mumbai Suburban,,,Anushakti Nagar,172,,82,4,484,0,488,0,RAJNAS DAZA AYILA,,119,923,1042,0,1042
Mumbai Suburban,,,Anushakti Nagar,172,,83,3,521,0,524,0,RAJNAS DAZA AYILA,,123,996,1119,0,1119
Mumbai Suburban,,,Anushakti Nagar,172,,84,6,472,0,478,0,RAJNAS DAZA AYILA,,113,903,1016,0,1016
Mumbai Suburban,,,Anushakti Nagar,172,,85,1,610,0,611,0,RAJNAS DAZA AYILA,,158,1145,1303,0,1303
Mumbai Suburban,,,Anushakti Nagar,172,,86,7,589,0,596,0,RAJNAS DAZA AYILA,,125,1125,1250,0,1250
Mumbai Suburban,,,Anushakti Nagar,172,,87,0,663,0,663,0,RAJNAS DAZA AYILA,,116,1297,1413,0,1413
Mumbai Suburban,,,Anushakti Nagar,172,,88,1,481,0,482,0,RAJNAS DAZA AYILA,,78,970,1048,0,1048
Mumbai Suburban,,,Anushakti Nagar,172,,89,4,339,0,343,0,RAJNAS DAZA AYILA,,79,680,759,0,759
Mumbai Suburban,,,Anushakti Nagar,172,,90,3,614,0,617,0,RAJNAS DAZA AYILA,,133,1179,1312,0,1312
Mumbai Suburban,,,Anushakti Nagar,172,,91,6,539,0,545,0,RAJNAS DAZA AYILA,,101,1056,1157,0,1157
Mumbai Suburban,,,Anushakti Nagar,172,,92,6,435,0,441,0,RAJNAS DAZA AYILA,,117,833,950,0,950
Mumbai Suburban,,,Anushakti Nagar,172,,93,3,667,0,670,0,RAJNAS DAZA AYILA,,169,1252,1421,0,1421
Mumbai Suburban,,,Anushakti Nagar,172,,94,2,629,0,631,0,RAJNAS DAZA AYILA,,141,1207,1348,0,1348
Mumbai Suburban,,,Anushakti Nagar,172,,95,5,658,0,663,0,RAJNAS DAZA AYILA,,154,1247,1401,0,1401
Mumbai Suburban,,,Anushakti Nagar,172,,96,3,722,0,725,0,RAJNAS DAZA AYILA,,159,1375,1534,0,1534
Mumbai Suburban,,,Anushakti Nagar,172,,97,1,563,0,564,0,RAJNAS DAZA AYILA,,123,1098,1221,0,1221
Mumbai Suburban,,,Anushakti Nagar,172,,98,5,634,0,639,0,RAJNAS DAZA AYILA,,120,1236,1356,0,1356
Mumbai Suburban,,,Anushakti Nagar,172,,99,5,622,0,627,0,RAJNAS DAZA AYILA,,158,1175,1333,0,1333
Mumbai Suburban,,,Anushakti Nagar,172,,100,2,553,0,555,0,RAJNAS DAZA AYILA,,103,1099,1202,0,1202
Mumbai Suburban,,,Anushakti Nagar,172,,101,10,440,0,450,0,RAJNAS DAZA AYILA,,146,815,961,0,961
Mumbai Suburban,,,Anushakti Nagar,172,,102,4,586,0,590,0,RAJNAS DAZA AYILA,,201,1065,1266,0,1266
Mumbai Suburban,,,Anushakti Nagar,172,,103,1,487,0,488,0,RAJNAS DAZA AYILA,,134,941,1075,0,1075
Mumbai Suburban,,,Anushakti Nagar,172,,104,5,605,0,610,0,RAJNAS DAZA AYILA,,168,1136,1304,0,1304
Mumbai Suburban,,,Anushakti Nagar,172,,105,6,360,0,366,0,RAJNAS DAZA AYILA,,55,758,813,0,813
Mumbai Suburban,,,Anushakti Nagar,172,,106,7,483,0,490,0,RAJNAS DAZA AYILA,,126,932,1058,0,1058
Mumbai Suburban,,,Anushakti Nagar,172,,107,3,520,0,523,0,RAJNAS DAZA AYILA,,148,993,1141,0,1141
Mumbai Suburban,,,Anushakti Nagar,172,,108,5,522,0,527,0,RAJNAS DAZA AYILA,,124,1018,1142,0,1142
Mumbai Suburban,,,Anushakti Nagar,172,,109,5,462,0,467,0,RAJNAS DAZA AYILA,,122,901,1023,0,1023
Mumbai Suburban,,,Anushakti Nagar,172,,110,5,482,0,487,0,RAJNAS DAZA AYILA,,102,962,1064,0,1064
Mumbai Suburban,,,Anushakti Nagar,172,,111,5,545,0,550,0,RAJNAS DAZA AYILA,,120,1071,1191,0,1191
Mumbai Suburban,,,Anushakti Nagar,172,,112,3,412,0,415,0,RAJNAS DAZA AYILA,,90,840,930,0,930
Mumbai Suburban,,,Anushakti Nagar,172,,113,5,483,0,488,0,RAJNAS DAZA AYILA,,118,951,1069,0,1069
Mumbai Suburban,,,Anushakti Nagar,172,,114,5,533,0,538,0,RAJNAS DAZA AYILA,,129,1041,1170,0,1170
Mumbai Suburban,,,Anushakti Nagar,172,,115,7,546,0,553,0,RAJNAS DAZA AYILA,,226,967,1193,0,1193
Mumbai Suburban,,,Anushakti Nagar,172,,116,5,622,0,627,0,RAJNAS DAZA AYILA,,165,1185,1350,0,1350
Mumbai Suburban,,,Anushakti Nagar,172,,117,4,525,0,529,0,RAJNAS DAZA AYILA,,140,1019,1159,0,1159
Mumbai Suburban,,,Anushakti Nagar,172,,118,7,511,0,518,0,RAJNAS DAZA AYILA,,171,955,1126,0,1126
Mumbai Suburban,,,Anushakti Nagar,172,,119,5,502,0,507,0,RAJNAS DAZA AYILA,,136,977,1113,0,1113
Mumbai Suburban,,,Anushakti Nagar,172,,120,4,482,0,486,0,RAJNAS DAZA AYILA,,144,932,1076,0,1076
Mumbai Suburban,,,Anushakti Nagar,172,,121,4,462,0,466,0,RAJNAS DAZA AYILA,,114,923,1037,0,1037
Mumbai Suburban,,,Anushakti Nagar,172,,122,6,700,0,706,0,RAJNAS DAZA AYILA,,193,1317,1510,0,1510
Mumbai Suburban,,,Anushakti Nagar,172,,123,7,621,0,628,0,RAJNAS DAZA AYILA,,234,1117,1351,0,1351
Mumbai Suburban,,,Anushakti Nagar,172,,124,7,506,0,513,0,RAJNAS DAZA AYILA,,200,922,1122,0,1122
Mumbai Suburban,,,Anushakti Nagar,172,,125,19,780,0,799,0,RAJNAS DAZA AYILA,,389,1258,1647,0,1647
Mumbai Suburban,,,Anushakti Nagar,172,,126,11,682,0,693,0,RAJNAS DAZA AYILA,,144,1324,1468,0,1468
Mumbai Suburban,,,Anushakti Nagar,172,,127,9,722,0,731,0,RAJNAS DAZA AYILA,,165,1388,1553,0,1553
Mumbai Suburban,,,Anushakti Nagar,172,,128,15,613,0,628,0,RAJNAS DAZA AYILA,,156,1168,1324,0,1324
Mumbai Suburban,,,Anushakti Nagar,172,,129,10,620,0,630,0,RAJNAS DAZA AYILA,,127,1222,1349,0,1349
Mumbai Suburban,,,Anushakti Nagar,172,,130,10,696,0,706,0,RAJNAS DAZA AYILA,,270,1232,1502,0,1502
Mumbai Suburban,,,Anushakti Nagar,172,,131,17,762,0,779,0,RAJNAS DAZA AYILA,,256,1365,1621,0,1621
Mumbai Suburban,,,Anushakti Nagar,172,,132,25,748,0,773,0,RAJNAS DAZA AYILA,,284,1294,1578,0,1578
Mumbai Suburban,,,Anushakti Nagar,172,,133,20,741,0,761,0,RAJNAS DAZA AYILA,,291,1284,1575,0,1575
Mumbai Suburban,,,Anushakti Nagar,172,,134,7,504,0,511,0,RAJNAS DAZA AYILA,,227,901,1128,0,1128
Mumbai Suburban,,,Anushakti Nagar,172,,135,19,742,0,761,0,RAJNAS DAZA AYILA,,333,1248,1581,0,1581
Mumbai Suburban,,,Anushakti Nagar,172,,136,37,593,0,630,0,RAJNAS DAZA AYILA,,153,1095,1248,0,1248
Mumbai Suburban,,,Anushakti Nagar,172,,137,33,458,0,491,0,RAJNAS DAZA AYILA,,119,868,987,0,987
Mumbai Suburban,,,Anushakti Nagar,172,,138,27,476,0,503,0,RAJNAS DAZA AYILA,,134,902,1036,0,1036
Mumbai Suburban,,,Anushakti Nagar,172,,139,23,539,0,562,0,RAJNAS DAZA AYILA,,166,1005,1171,0,1171
Mumbai Suburban,,,Anushakti Nagar,172,,140,32,517,0,549,0,RAJNAS DAZA AYILA,,136,974,1110,0,1110
Mumbai Suburban,,,Anushakti Nagar,172,,141,25,470,0,495,0,RAJNAS DAZA AYILA,,107,924,1031,0,1031
Mumbai Suburban,,,Anushakti Nagar,172,,142,53,573,0,626,0,RAJNAS DAZA AYILA,,133,1049,1182,0,1182
Mumbai Suburban,,,Anushakti Nagar,172,,143,27,553,0,580,0,RAJNAS DAZA AYILA,,124,1071,1195,0,1195
Mumbai Suburban,,,Anushakti Nagar,172,,144,29,525,0,554,0,RAJNAS DAZA AYILA,,118,1018,1136,0,1136
Mumbai Suburban,,,Anushakti Nagar,172,,145,28,523,0,551,0,RAJNAS DAZA AYILA,,131,1004,1135,0,1135
Mumbai Suburban,,,Anushakti Nagar,172,,146,33,595,0,628,0,RAJNAS DAZA AYILA,,165,1105,1270,0,1270
Mumbai Suburban,,,Anushakti Nagar,172,,147,51,605,0,656,0,RAJNAS DAZA AYILA,,144,1111,1255,0,1255
Mumbai Suburban,,,Anushakti Nagar,172,,148,28,398,0,426,0,RAJNAS DAZA AYILA,,124,764,888,0,888
Mumbai Suburban,,,Anushakti Nagar,172,,149,44,517,0,561,0,RAJNAS DAZA AYILA,,215,880,1095,0,1095
Mumbai Suburban,,,Anushakti Nagar,172,,150,29,501,0,530,0,RAJNAS DAZA AYILA,,139,955,1094,0,1094
Mumbai Suburban,,,Anushakti Nagar,172,,151,25,355,0,380,0,RAJNAS DAZA AYILA,,97,714,811,0,811
Mumbai Suburban,,,Anushakti Nagar,172,,152,28,328,0,356,0,RAJNAS DAZA AYILA,,95,657,752,0,752
Mumbai Suburban,,,Anushakti Nagar,172,,153,46,468,0,514,0,RAJNAS DAZA AYILA,,130,867,997,0,997
Mumbai Suburban,,,Anushakti Nagar,172,,154,24,438,0,462,0,RAJNAS DAZA AYILA,,115,867,982,0,982
Mumbai Suburban,,,Anushakti Nagar,172,,155,50,617,0,667,0,RAJNAS DAZA AYILA,,156,1133,1289,0,1289
Mumbai Suburban,,,Anushakti Nagar,172,,156,30,390,0,420,0,RAJNAS DAZA AYILA,,85,791,876,0,876
Mumbai Suburban,,,Anushakti Nagar,172,,157,49,556,0,605,0,RAJNAS DAZA AYILA,,163,1008,1171,0,1171
Mumbai Suburban,,,Anushakti Nagar,172,,158,27,360,0,387,0,RAJNAS DAZA AYILA,,83,741,824,0,824
Mumbai Suburban,,,Anushakti Nagar,172,,159,26,459,0,485,0,RAJNAS DAZA AYILA,,164,861,1025,0,1025
Mumbai Suburban,,,Anushakti Nagar,172,,160,21,551,0,572,0,RAJNAS DAZA AYILA,,135,1085,1220,0,1220
Mumbai Suburban,,,Anushakti Nagar,172,,161,22,474,0,496,0,RAJNAS DAZA AYILA,,157,908,1065,0,1065
Mumbai Suburban,,,Anushakti Nagar,172,,162,13,728,0,741,0,RAJNAS DAZA AYILA,,140,1452,1592,0,1592
Mumbai Suburban,,,Anushakti Nagar,172,,163,11,728,0,739,0,RAJNAS DAZA AYILA,,181,1416,1597,0,1597
Mumbai Suburban,,,Anushakti Nagar,172,,164,9,462,0,471,0,RAJNAS DAZA AYILA,,104,966,1070,0,1070
Mumbai Suburban,,,Anushakti Nagar,172,,165,18,514,0,532,0,RAJNAS DAZA AYILA,,132,1025,1157,0,1157
Mumbai Suburban,,,Anushakti Nagar,172,,166,13,426,0,439,0,RAJNAS DAZA AYILA,,105,887,992,0,992
Mumbai Suburban,,,Anushakti Nagar,172,,167,16,475,0,491,0,RAJNAS DAZA AYILA,,144,941,1085,0,1085
Mumbai Suburban,,,Anushakti Nagar,172,,168,5,571,0,576,0,RAJNAS DAZA AYILA,,85,1215,1300,0,1300
Mumbai Suburban,,,Anushakti Nagar,172,,169,7,498,0,505,0,RAJNAS DAZA AYILA,,152,999,1151,0,1151
Mumbai Suburban,,,Anushakti Nagar,172,,170,11,401,0,412,0,RAJNAS DAZA AYILA,,85,865,950,0,950
Mumbai Suburban,,,Anushakti Nagar,172,,171,3,387,0,390,0,RAJNAS DAZA AYILA,,107,832,939,0,939
Mumbai Suburban,,,Anushakti Nagar,172,,172,12,574,0,586,0,RAJNAS DAZA AYILA,,137,1159,1296,0,1296
Mumbai Suburban,,,Anushakti Nagar,172,,173,4,305,0,309,0,RAJNAS DAZA AYILA,,72,703,775,0,775
Mumbai Suburban,,,Anushakti Nagar,172,,174,16,710,0,726,0,RAJNAS DAZA AYILA,,96,1466,1562,0,1562
Mumbai Suburban,,,Anushakti Nagar,172,,175,32,691,0,723,0,RAJNAS DAZA AYILA,,128,1365,1493,0,1493
Mumbai Suburban,,,Anushakti Nagar,172,,176,21,641,0,662,0,RAJNAS DAZA AYILA,,217,1199,1416,0,1416
Mumbai Suburban,,,Anushakti Nagar,172,,177,36,468,0,504,0,RAJNAS DAZA AYILA,,154,887,1041,0,1041
Mumbai Suburban,,,Anushakti Nagar,172,,178,30,394,0,424,0,RAJNAS DAZA AYILA,,81,825,906,0,906
Mumbai Suburban,,,Anushakti Nagar,172,,179,39,418,0,457,0,RAJNAS DAZA AYILA,,118,819,937,0,937
Mumbai Suburban,,,Anushakti Nagar,172,,180,17,344,0,361,0,RAJNAS DAZA AYILA,,69,765,834,0,834
Mumbai Suburban,,,Anushakti Nagar,172,,181,29,447,0,476,0,RAJNAS DAZA AYILA,,137,880,1017,0,1017
Mumbai Suburban,,,Anushakti Nagar,172,,182,25,405,0,430,0,RAJNAS DAZA AYILA,,132,810,942,0,942
Mumbai Suburban,,,Anushakti Nagar,172,,183,14,631,0,645,0,RAJNAS DAZA AYILA,,183,1234,1417,0,1417
Mumbai Suburban,,,Anushakti Nagar,172,,184,5,396,0,401,0,RAJNAS DAZA AYILA,,105,861,966,0,966
Mumbai Suburban,,,Anushakti Nagar,172,,185,11,443,0,454,0,RAJNAS DAZA AYILA,,139,910,1049,0,1049
Mumbai Suburban,,,Anushakti Nagar,172,,186,9,406,0,415,0,RAJNAS DAZA AYILA,,118,862,980,0,980
Mumbai Suburban,,,Anushakti Nagar,172,,187,13,482,0,495,0,RAJNAS DAZA AYILA,,205,920,1125,0,1125
Mumbai Suburban,,,Anushakti Nagar,172,,188,13,598,0,611,0,RAJNAS DAZA AYILA,,226,1132,1358,0,1358
Mumbai Suburban,,,Anushakti Nagar,172,,189,8,443,0,451,0,RAJNAS DAZA AYILA,,93,966,1059,0,1059
Mumbai Suburban,,,Anushakti Nagar,172,,190,7,655,0,662,0,RAJNAS DAZA AYILA,,291,1195,1486,0,1486
Mumbai Suburban,,,Anushakti Nagar,172,,191,31,427,0,458,0,RAJNAS DAZA AYILA,,147,836,983,0,983
Mumbai Suburban,,,Anushakti Nagar,172,,192,13,255,0,268,0,RAJNAS DAZA AYILA,,99,577,676,0,676
Mumbai Suburban,,,Anushakti Nagar,172,,193,4,428,0,432,0,RAJNAS DAZA AYILA,,156,885,1041,0,1041
Mumbai Suburban,,,Anushakti Nagar,172,,194,12,407,0,419,0,RAJNAS DAZA AYILA,,159,825,984,0,984
Mumbai Suburban,,,Anushakti Nagar,172,,195,24,671,0,695,0,RAJNAS DAZA AYILA,,281,1208,1489,0,1489
Mumbai Suburban,,,Anushakti Nagar,172,,196,9,639,0,648,0,RAJNAS DAZA AYILA,,344,1112,1456,0,1456
Mumbai Suburban,,,Anushakti Nagar,172,,197,11,525,0,536,0,RAJNAS DAZA AYILA,,202,1023,1225,0,1225
Mumbai Suburban,,,Anushakti Nagar,172,,198,7,529,0,536,0,RAJNAS DAZA AYILA,,214,1028,1242,0,1242
Mumbai Suburban,,,Anushakti Nagar,172,,199,16,659,0,675,0,RAJNAS DAZA AYILA,,311,1174,1485,0,1485
Mumbai Suburban,,,Anushakti Nagar,172,,200,11,544,0,555,0,RAJNAS DAZA AYILA,,194,1072,1266,0,1266
Mumbai Suburban,,,Anushakti Nagar,172,,201,11,767,0,778,0,RAJNAS DAZA AYILA,,270,1443,1713,0,1713
Mumbai Suburban,,,Anushakti Nagar,172,,202,9,541,0,550,0,RAJNAS DAZA AYILA,,207,1059,1266,0,1266
Mumbai Suburban,,,Anushakti Nagar,172,,203,13,721,0,734,0,RAJNAS DAZA AYILA,,269,1350,1619,0,1619
Mumbai Suburban,,,Anushakti Nagar,172,,204,17,601,0,618,0,RAJNAS DAZA AYILA,,256,1116,1372,0,1372
Mumbai Suburban,,,Anushakti Nagar,172,,205,12,569,0,581,0,RAJNAS DAZA AYILA,,247,1072,1319,0,1319
Mumbai Suburban,,,Anushakti Nagar,172,,206,8,366,0,374,0,RAJNAS DAZA AYILA,,155,767,922,0,922
Mumbai Suburban,,,Anushakti Nagar,172,,207,13,545,0,558,0,RAJNAS DAZA AYILA,,223,1048,1271,0,1271
Mumbai Suburban,,,Anushakti Nagar,172,,208,17,631,0,648,0,RAJNAS DAZA AYILA,,246,1190,1436,0,1436
Mumbai Suburban,,,Anushakti Nagar,172,,209,2,316,0,318,0,RAJNAS DAZA AYILA,,140,697,837,0,837
Mumbai Suburban,,,Anushakti Nagar,172,,210,8,332,0,340,0,RAJNAS DAZA AYILA,,118,740,858,0,858
Mumbai Suburban,,,Anushakti Nagar,172,,211,9,455,0,464,0,RAJNAS DAZA AYILA,,157,946,1103,0,1103
Mumbai Suburban,,,Anushakti Nagar,172,,212,6,518,0,524,0,RAJNAS DAZA AYILA,,127,1109,1236,0,1236
Mumbai Suburban,,,Anushakti Nagar,172,,213,13,667,0,680,0,RAJNAS DAZA AYILA,,162,1359,1521,0,1521
Mumbai Suburban,,,Anushakti Nagar,172,,214,13,694,0,707,0,RAJNAS DAZA AYILA,,144,1432,1576,0,1576
Mumbai Suburban,,,Anushakti Nagar,172,,215,16,546,0,562,0,RAJNAS DAZA AYILA,,207,1068,1275,0,1275
Mumbai Suburban,,,Anushakti Nagar,172,,216,15,745,0,760,0,RAJNAS DAZA AYILA,,244,1432,1676,0,1676
Mumbai Suburban,,,Anushakti Nagar,172,,217,11,537,0,548,0,RAJNAS DAZA AYILA,,215,1054,1269,0,1269
Mumbai Suburban,,,Anushakti Nagar,172,,218,22,697,0,719,0,RAJNAS DAZA AYILA,,339,1229,1568,0,1568
Mumbai Suburban,,,Anushakti Nagar,172,,219,18,508,0,526,0,RAJNAS DAZA AYILA,,202,997,1199,0,1199
Mumbai Suburban,,,Anushakti Nagar,172,,220,3,559,0,562,0,RAJNAS DAZA AYILA,,256,1076,1332,0,1332
Mumbai Suburban,,,Anushakti Nagar,172,,221,25,604,0,629,0,RAJNAS DAZA AYILA,,208,1171,1379,0,1379
Mumbai Suburban,,,Anushakti Nagar,172,,222,13,589,0,602,0,RAJNAS DAZA AYILA,,227,1147,1374,0,1374
Mumbai Suburban,,,Anushakti Nagar,172,,223,8,405,0,413,0,RAJNAS DAZA AYILA,,150,867,1017,0,1017
Mumbai Suburban,,,Anushakti Nagar,172,,224,14,596,0,610,0,RAJNAS DAZA AYILA,,186,1202,1388,0,1388
Mumbai Suburban,,,Anushakti Nagar,172,,225,18,627,0,645,0,RAJNAS DAZA AYILA,,219,1224,1443,0,1443
Mumbai Suburban,,,Anushakti Nagar,172,,226,12,700,0,712,0,RAJNAS DAZA AYILA,,216,1386,1602,0,1602
Mumbai Suburban,,,Anushakti Nagar,172,,227,11,597,0,608,0,RAJNAS DAZA AYILA,,265,1134,1399,0,1399
Mumbai Suburban,,,Anushakti Nagar,172,,228,7,335,0,342,0,RAJNAS DAZA AYILA,,133,751,884,0,884
Mumbai Suburban,,,Anushakti Nagar,172,,229,23,490,0,513,0,RAJNAS DAZA AYILA,,273,890,1163,0,1163
Mumbai Suburban,,,Anushakti Nagar,172,,230,20,701,0,721,0,RAJNAS DAZA AYILA,,241,1351,1592,0,1592
Mumbai Suburban,,,Anushakti Nagar,172,,231,11,834,0,845,0,RAJNAS DAZA AYILA,,293,1584,1877,0,1877
Mumbai Suburban,,,Anushakti Nagar,172,,232,9,468,0,477,0,RAJNAS DAZA AYILA,,244,906,1150,0,1150
Mumbai Suburban,,,Anushakti Nagar,172,,233,25,393,0,418,0,RAJNAS DAZA AYILA,,70,899,969,0,969
Mumbai Suburban,,,Anushakti Nagar,172,,234,17,744,0,761,0,RAJNAS DAZA AYILA,,270,1418,1688,0,1688
Mumbai Suburban,,,Anushakti Nagar,172,,235,18,699,0,717,0,RAJNAS DAZA AYILA,,275,1322,1597,0,1597
Mumbai Suburban,,,Anushakti Nagar,172,,236,18,648,0,666,0,RAJNAS DAZA AYILA,,306,1190,1496,0,1496
Mumbai Suburban,,,Anushakti Nagar,172,,237,9,621,0,630,0,RAJNAS DAZA AYILA,,260,1201,1461,0,1461
Mumbai Suburban,,,Anushakti Nagar,172,,238,16,555,0,571,0,RAJNAS DAZA AYILA,,186,1130,1316,0,1316
Mumbai Suburban,,,Anushakti Nagar,172,,239,14,468,0,482,0,RAJNAS DAZA AYILA,,132,1015,1147,0,1147
Mumbai Suburban,,,Anushakti Nagar,172,,240,15,421,0,436,0,RAJNAS DAZA AYILA,,190,862,1052,0,1052
Mumbai Suburban,,,Anushakti Nagar,172,,241,17,523,0,540,0,RAJNAS DAZA AYILA,,232,1021,1253,0,1253
Mumbai Suburban,,,Anushakti Nagar,172,,242,13,598,0,611,0,RAJNAS DAZA AYILA,,270,1142,1412,0,1412
Mumbai Suburban,,,Anushakti Nagar,172,,243,7,394,0,401,0,RAJNAS DAZA AYILA,,141,876,1017,0,1017
Mumbai Suburban,,,Anushakti Nagar,172,,244,15,391,0,406,0,RAJNAS DAZA AYILA,,197,799,996,0,996
Mumbai Suburban,,,Anushakti Nagar,172,,245,10,528,0,538,0,RAJNAS DAZA AYILA,,205,1076,1281,0,1281
Mumbai Suburban,,,Anushakti Nagar,172,,246,10,590,0,600,0,RAJNAS DAZA AYILA,,251,1155,1406,0,1406
Mumbai Suburban,,,Anushakti Nagar,172,,247,11,621,0,632,0,RAJNAS DAZA AYILA,,232,1235,1467,0,1467
Mumbai Suburban,,,Anushakti Nagar,172,,248,16,725,0,741,0,RAJNAS DAZA AYILA,,292,1374,1666,0,1666
Mumbai Suburban,,,Anushakti Nagar,172,,249,18,571,0,589,0,RAJNAS DAZA AYILA,,235,1120,1355,0,1355
Mumbai Suburban,,,Anushakti Nagar,172,,250,11,612,0,623,0,RAJNAS DAZA AYILA,,256,1196,1452,0,1452
Mumbai Suburban,,,Anushakti Nagar,172,,251,19,538,0,557,0,RAJNAS DAZA AYILA,,209,1080,1289,0,1289
Mumbai Suburban,,,Anushakti Nagar,172,,252,21,670,0,691,0,RAJNAS DAZA AYILA,,337,1213,1550,0,1550
Mumbai Suburban,,,Anushakti Nagar,172,,253,11,592,0,603,0,RAJNAS DAZA AYILA,,300,1115,1415,0,1415
Mumbai Suburban,,,Anushakti Nagar,172,,254,6,692,0,698,0,RAJNAS DAZA AYILA,,385,1241,1626,0,1626
Mumbai Suburban,,,Anushakti Nagar,172,,255,10,556,0,566,0,RAJNAS DAZA AYILA,,288,1059,1347,0,1347
Mumbai Suburban,,,Anushakti Nagar,172,,256,11,599,0,610,0,RAJNAS DAZA AYILA,,353,1079,1432,0,1432
Mumbai Suburban,,,Anushakti Nagar,172,,257,11,456,0,467,0,RAJNAS DAZA AYILA,,236,911,1147,0,1147
Mumbai Suburban,,,Anushakti Nagar,172,,258,9,485,0,494,0,RAJNAS DAZA AYILA,,264,946,1210,0,1210
Mumbai Suburban,,,Anushakti Nagar,172,,259,20,646,0,666,0,RAJNAS DAZA AYILA,,265,1246,1511,0,1511
Mumbai Suburban,,,Anushakti Nagar,172,,260,6,699,0,705,0,RAJNAS DAZA AYILA,,312,1334,1646,0,1646
Mumbai Suburban,,,Anushakti Nagar,172,,261,31,732,0,763,0,RAJNAS DAZA AYILA,,266,1397,1663,0,1663
Mumbai Suburban,,,Anushakti Nagar,172,,262,16,649,0,665,0,RAJNAS DAZA AYILA,,280,1248,1528,0,1528
TOTAL,,,,,,,3826,145406,0,149232,0,,,49140,268473,317613,0,317613
