District Name,District No,Jilha,Constituency Name,Constituency No,Total No. of Electors,Serial Poll,Total No. Valid Votes,No. of Rejected Votes,NOTA,Total,No. of Tendered Votes,Elected Person Name,Party Name of Elected Person,No. of Valid Votes Cast in Favour of Elected Person,Other Candidate Votes,Total EVM Votes,Total Postal ballot votes,Total Votes Polled
Beed,,,Majalgaon,229,,1,9,3,0,12,1,EKNALOS OARRADANUS )ADAD( HSAKARP,,1,371,372,1,373
Beed,,,Majalgaon,229,,2,4,2,0,6,0,EKNALOS OARRADANUS )ADAD( HSAKARP,,2,450,452,0,452
Beed,,,Majalgaon,229,,3,5,0,0,5,4,EKNALOS OARRADANUS )ADAD( HSAKARP,,3,469,472,4,476
Beed,,,Majalgaon,229,,4,16,1,0,17,3,EKNALOS OARRADANUS )ADAD( HSAKARP,,4,706,710,3,713
Beed,,,Majalgaon,229,,5,8,1,0,9,3,EKNALOS OARRADANUS )ADAD( HSAKARP,,5,629,634,3,637
Beed,,,Majalgaon,229,,6,9,4,0,13,4,EKNALOS OARRADANUS )ADAD( HSAKARP,,6,392,398,4,402
Beed,,,Majalgaon,229,,7,3,1,0,4,3,EKNALOS OARRADANUS )ADAD( HSAKARP,,7,575,582,3,585
Beed,,,Majalgaon,229,,8,1,2,0,3,4,EKNALOS OARRADANUS )ADAD( HSAKARP,,8,207,215,4,219
Beed,,,Majalgaon,229,,9,8,1,0,9,4,EKNALOS OARRADANUS )ADAD( HSAKARP,,9,532,541,4,545
Beed,,,Majalgaon,229,,10,1,2,0,3,1,EKNALOS OARRADANUS )ADAD( HSAKARP,,10,367,377,1,378
Beed,,,Majalgaon,229,,11,3,1,0,4,0,EKNALOS OARRADANUS )ADAD( HSAKARP,,11,336,347,0,347
Beed,,,Majalgaon,229,,12,0,0,0,0,0,EKNALOS OARRADANUS )ADAD( HSAKARP,,12,386,398,0,398
Beed,,,Majalgaon,229,,13,1,1,0,2,1,EKNALOS OARRADANUS )ADAD( HSAKARP,,13,236,249,1,250
Beed,,,Majalgaon,229,,14,14,1,0,15,2,EKNALOS OARRADANUS )ADAD( HSAKARP,,14,648,662,2,664
Beed,,,Majalgaon,229,,15,13,1,0,14,7,EKNALOS OARRADANUS )ADAD( HSAKARP,,15,785,800,7,807
Beed,,,Majalgaon,229,,16,11,2,0,13,0,EKNALOS OARRADANUS )ADAD( HSAKARP,,16,457,473,0,473
Beed,,,Majalgaon,229,,17,2,0,0,2,1,EKNALOS OARRADANUS )ADAD( HSAKARP,,17,369,386,1,387
Beed,,,Majalgaon,229,,18,4,3,0,7,1,EKNALOS OARRADANUS )ADAD( HSAKARP,,18,640,658,1,659
Beed,,,Majalgaon,229,,19,19,0,0,19,14,EKNALOS OARRADANUS )ADAD( HSAKARP,,19,618,637,14,651
Beed,,,Majalgaon,229,,20,10,2,0,12,3,EKNALOS OARRADANUS )ADAD( HSAKARP,,20,709,729,3,732
Beed,,,Majalgaon,229,,21,2,1,0,3,0,EKNALOS OARRADANUS )ADAD( HSAKARP,,21,431,452,0,452
Beed,,,Majalgaon,229,,22,9,1,0,10,1,EKNALOS OARRADANUS )ADAD( HSAKARP,,22,356,378,1,379
Beed,,,Majalgaon,229,,23,0,2,0,2,0,EKNALOS OARRADANUS )ADAD( HSAKARP,,23,99,122,0,122
Beed,,,Majalgaon,229,,24,1,0,0,1,0,EKNALOS OARRADANUS )ADAD( HSAKARP,,24,213,237,0,237
Beed,,,Majalgaon,229,,25,2,1,0,3,1,EKNALOS OARRADANUS )ADAD( HSAKARP,,25,432,457,1,458
Beed,,,Majalgaon,229,,26,2,1,0,3,0,EKNALOS OARRADANUS )ADAD( HSAKARP,,26,443,469,0,469
Beed,,,Majalgaon,229,,27,1,1,0,2,1,EKNALOS OARRADANUS )ADAD( HSAKARP,,27,197,224,1,225
Beed,,,Majalgaon,229,,28,7,1,0,8,1,EKNALOS OARRADANUS )ADAD( HSAKARP,,28,389,417,1,418
Beed,,,Majalgaon,229,,29,6,0,0,6,1,EKNALOS OARRADANUS )ADAD( HSAKARP,,29,678,707,1,708
Beed,,,Majalgaon,229,,30,0,1,0,1,0,EKNALOS OARRADANUS )ADAD( HSAKARP,,30,76,106,0,106
Beed,,,Majalgaon,229,,31,8,1,0,9,0,EKNALOS OARRADANUS )ADAD( HSAKARP,,31,449,480,0,480
Beed,,,Majalgaon,229,,32,0,0,0,0,0,EKNALOS OARRADANUS )ADAD( HSAKARP,,32,341,373,0,373
Beed,,,Majalgaon,229,,33,1,0,0,1,0,EKNALOS OARRADANUS )ADAD( HSAKARP,,33,270,303,0,303
Beed,,,Majalgaon,229,,34,3,3,0,6,1,EKNALOS OARRADANUS )ADAD( HSAKARP,,34,409,443,1,444
Beed,,,Majalgaon,229,,35,5,1,0,6,0,EKNALOS OARRADANUS )ADAD( HSAKARP,,35,126,161,0,161
Beed,,,Majalgaon,229,,36,5,2,0,7,1,EKNALOS OARRADANUS )ADAD( HSAKARP,,36,320,356,1,357
Beed,,,Majalgaon,229,,37,1,1,0,2,0,EKNALOS OARRADANUS )ADAD( HSAKARP,,37,188,225,0,225
Beed,,,Majalgaon,229,,38,4,0,0,4,1,EKNALOS OARRADANUS )ADAD( HSAKARP,,38,480,518,1,519
Beed,,,Majalgaon,229,,39,5,0,0,5,2,EKNALOS OARRADANUS )ADAD( HSAKARP,,39,495,534,2,536
Beed,,,Majalgaon,229,,40,7,0,0,7,1,EKNALOS OARRADANUS )ADAD( HSAKARP,,40,465,505,1,506
Beed,,,Majalgaon,229,,41,11,4,0,15,5,EKNALOS OARRADANUS )ADAD( HSAKARP,,41,566,607,5,612
Beed,,,Majalgaon,229,,42,13,7,0,20,0,EKNALOS OARRADANUS )ADAD( HSAKARP,,42,484,526,0,526
Beed,,,Majalgaon,229,,43,3,2,0,5,1,EKNALOS OARRADANUS )ADAD( HSAKARP,,43,243,286,1,287
Beed,,,Majalgaon,229,,44,2,0,0,2,0,EKNALOS OARRADANUS )ADAD( HSAKARP,,44,390,434,0,434
Beed,,,Majalgaon,229,,45,4,2,0,6,0,EKNALOS OARRADANUS )ADAD( HSAKARP,,45,383,428,0,428
Beed,,,Majalgaon,229,,46,2,1,0,3,0,EKNALOS OARRADANUS )ADAD( HSAKARP,,46,299,345,0,345
Beed,,,Majalgaon,229,,47,3,0,0,3,1,EKNALOS OARRADANUS )ADAD( HSAKARP,,47,303,350,1,351
Beed,,,Majalgaon,229,,48,3,0,0,3,1,EKNALOS OARRADANUS )ADAD( HSAKARP,,48,345,393,1,394
Beed,,,Majalgaon,229,,49,0,0,0,0,0,EKNALOS OARRADANUS )ADAD( HSAKARP,,49,150,199,0,199
Beed,,,Majalgaon,229,,50,6,1,0,7,0,EKNALOS OARRADANUS )ADAD( HSAKARP,,50,404,454,0,454
Beed,,,Majalgaon,229,,51,1,1,0,2,1,EKNALOS OARRADANUS )ADAD( HSAKARP,,51,288,339,1,340
Beed,,,Majalgaon,229,,52,9,2,0,11,3,EKNALOS OARRADANUS )ADAD( HSAKARP,,52,522,574,3,577
Beed,,,Majalgaon,229,,53,4,1,0,5,1,EKNALOS OARRADANUS )ADAD( HSAKARP,,53,374,427,1,428
Beed,,,Majalgaon,229,,54,11,1,0,12,6,EKNALOS OARRADANUS )ADAD( HSAKARP,,54,428,482,6,488
Beed,,,Majalgaon,229,,55,2,1,0,3,0,EKNALOS OARRADANUS )ADAD( HSAKARP,,55,258,313,0,313
Beed,,,Majalgaon,229,,56,10,0,0,10,0,EKNALOS OARRADANUS )ADAD( HSAKARP,,56,810,866,0,866
Beed,,,Majalgaon,229,,57,8,5,0,13,0,EKNALOS OARRADANUS )ADAD( HSAKARP,,57,328,385,0,385
Beed,,,Majalgaon,229,,58,2,1,0,3,1,EKNALOS OARRADANUS )ADAD( HSAKARP,,58,291,349,1,350
Beed,,,Majalgaon,229,,59,7,0,0,7,1,EKNALOS OARRADANUS )ADAD( HSAKARP,,59,316,375,1,376
Beed,,,Majalgaon,229,,60,2,0,0,2,0,EKNALOS OARRADANUS )ADAD( HSAKARP,,60,231,291,0,291
Beed,,,Majalgaon,229,,61,1,0,0,1,1,EKNALOS OARRADANUS )ADAD( HSAKARP,,61,150,211,1,212
Beed,,,Majalgaon,229,,62,5,0,0,5,0,EKNALOS OARRADANUS )ADAD( HSAKARP,,62,278,340,0,340
Beed,,,Majalgaon,229,,63,4,2,0,6,4,EKNALOS OARRADANUS )ADAD( HSAKARP,,63,397,460,4,464
Beed,,,Majalgaon,229,,64,3,3,0,6,1,EKNALOS OARRADANUS )ADAD( HSAKARP,,64,465,529,1,530
Beed,,,Majalgaon,229,,65,1,0,0,1,4,EKNALOS OARRADANUS )ADAD( HSAKARP,,65,624,689,4,693
Beed,,,Majalgaon,229,,66,4,1,0,5,2,EKNALOS OARRADANUS )ADAD( HSAKARP,,66,555,621,2,623
Beed,,,Majalgaon,229,,67,5,2,0,7,8,EKNALOS OARRADANUS )ADAD( HSAKARP,,67,791,858,8,866
Beed,,,Majalgaon,229,,68,2,1,0,3,3,EKNALOS OARRADANUS )ADAD( HSAKARP,,68,487,555,3,558
Beed,,,Majalgaon,229,,69,1,1,0,2,4,EKNALOS OARRADANUS )ADAD( HSAKARP,,69,486,555,4,559
Beed,,,Majalgaon,229,,70,8,1,0,9,0,EKNALOS OARRADANUS )ADAD( HSAKARP,,70,427,497,0,497
Beed,,,Majalgaon,229,,71,5,0,0,5,1,EKNALOS OARRADANUS )ADAD( HSAKARP,,71,307,378,1,379
Beed,,,Majalgaon,229,,72,6,1,0,7,5,EKNALOS OARRADANUS )ADAD( HSAKARP,,72,480,552,5,557
Beed,,,Majalgaon,229,,73,7,0,0,7,2,EKNALOS OARRADANUS )ADAD( HSAKARP,,73,565,638,2,640
Beed,,,Majalgaon,229,,74,2,0,0,2,1,EKNALOS OARRADANUS )ADAD( HSAKARP,,74,434,508,1,509
Beed,,,Majalgaon,229,,75,1,1,0,2,1,EKNALOS OARRADANUS )ADAD( HSAKARP,,75,448,523,1,524
Beed,,,Majalgaon,229,,76,8,1,0,9,1,EKNALOS OARRADANUS )ADAD( HSAKARP,,76,745,821,1,822
Beed,,,Majalgaon,229,,77,1,0,0,1,0,EKNALOS OARRADANUS )ADAD( HSAKARP,,77,412,489,0,489
Beed,,,Majalgaon,229,,78,1,3,0,4,0,EKNALOS OARRADANUS )ADAD( HSAKARP,,78,507,585,0,585
Beed,,,Majalgaon,229,,79,1,0,0,1,0,EKNALOS OARRADANUS )ADAD( HSAKARP,,79,637,716,0,716
Beed,,,Majalgaon,229,,80,5,1,0,6,2,EKNALOS OARRADANUS )ADAD( HSAKARP,,80,592,672,2,674
Beed,,,Majalgaon,229,,81,2,1,0,3,3,EKNALOS OARRADANUS )ADAD( HSAKARP,,81,621,702,3,705
Beed,,,Majalgaon,229,,82,6,1,0,7,2,EKNALOS OARRADANUS )ADAD( HSAKARP,,82,276,358,2,360
Beed,,,Majalgaon,229,,83,1,1,0,2,2,EKNALOS OARRADANUS )ADAD( HSAKARP,,83,366,449,2,451
Beed,,,Majalgaon,229,,84,3,0,0,3,3,EKNALOS OARRADANUS )ADAD( HSAKARP,,84,387,471,3,474
Beed,,,Majalgaon,229,,85,7,1,0,8,6,EKNALOS OARRADANUS )ADAD( HSAKARP,,85,850,935,6,941
Beed,,,Majalgaon,229,,86,3,0,0,3,0,EKNALOS OARRADANUS )ADAD( HSAKARP,,86,586,672,0,672
Beed,,,Majalgaon,229,,87,5,0,0,5,1,EKNALOS OARRADANUS )ADAD( HSAKARP,,87,695,782,1,783
Beed,,,Majalgaon,229,,88,0,0,0,0,1,EKNALOS OARRADANUS )ADAD( HSAKARP,,88,402,490,1,491
Beed,,,Majalgaon,229,,89,2,1,0,3,1,EKNALOS OARRADANUS )ADAD( HSAKARP,,89,424,513,1,514
Beed,,,Majalgaon,229,,90,0,1,0,1,0,EKNALOS OARRADANUS )ADAD( HSAKARP,,90,254,344,0,344
Beed,,,Majalgaon,229,,92,3,2,0,5,4,EKNALOS OARRADANUS )ADAD( HSAKARP,,92,481,573,4,577
Beed,,,Majalgaon,229,,93,3,0,0,3,2,EKNALOS OARRADANUS )ADAD( HSAKARP,,93,309,402,2,404
Beed,,,Majalgaon,229,,94,2,2,0,4,0,EKNALOS OARRADANUS )ADAD( HSAKARP,,94,490,584,0,584
Beed,,,Majalgaon,229,,95,6,3,0,9,1,EKNALOS OARRADANUS )ADAD( HSAKARP,,95,687,782,1,783
Beed,,,Majalgaon,229,,96,4,1,0,5,0,EKNALOS OARRADANUS )ADAD( HSAKARP,,96,381,477,0,477
Beed,,,Majalgaon,229,,97,10,1,0,11,3,EKNALOS OARRADANUS )ADAD( HSAKARP,,97,467,564,3,567
Beed,,,Majalgaon,229,,98,8,0,0,8,1,EKNALOS OARRADANUS )ADAD( HSAKARP,,98,371,469,1,470
Beed,,,Majalgaon,229,,99,4,1,0,5,4,EKNALOS OARRADANUS )ADAD( HSAKARP,,99,741,840,4,844
Beed,,,Majalgaon,229,,100,3,0,0,3,2,EKNALOS OARRADANUS )ADAD( HSAKARP,,100,461,561,2,563
Beed,,,Majalgaon,229,,101,1,2,0,3,0,EKNALOS OARRADANUS )ADAD( HSAKARP,,101,327,428,0,428
Beed,,,Majalgaon,229,,102,4,1,0,5,8,EKNALOS OARRADANUS )ADAD( HSAKARP,,102,707,809,8,817
Beed,,,Majalgaon,229,,103,5,1,0,6,0,EKNALOS OARRADANUS )ADAD( HSAKARP,,103,315,418,0,418
Beed,,,Majalgaon,229,,104,4,4,0,8,0,EKNALOS OARRADANUS )ADAD( HSAKARP,,104,342,446,0,446
Beed,,,Majalgaon,229,,105,17,4,0,21,3,EKNALOS OARRADANUS )ADAD( HSAKARP,,105,509,614,3,617
Beed,,,Majalgaon,229,,106,1,0,0,1,0,EKNALOS OARRADANUS )ADAD( HSAKARP,,106,264,370,0,370
Beed,,,Majalgaon,229,,107,1,1,0,2,3,EKNALOS OARRADANUS )ADAD( HSAKARP,,107,341,448,3,451
Beed,,,Majalgaon,229,,108,5,1,0,6,2,EKNALOS OARRADANUS )ADAD( HSAKARP,,108,234,342,2,344
Beed,,,Majalgaon,229,,109,9,0,0,9,0,EKNALOS OARRADANUS )ADAD( HSAKARP,,109,392,501,0,501
Beed,,,Majalgaon,229,,110,2,3,0,5,1,EKNALOS OARRADANUS )ADAD( HSAKARP,,110,220,330,1,331
Beed,,,Majalgaon,229,,111,9,0,0,9,2,EKNALOS OARRADANUS )ADAD( HSAKARP,,111,596,707,2,709
Beed,,,Majalgaon,229,,112,14,2,0,16,5,EKNALOS OARRADANUS )ADAD( HSAKARP,,112,729,841,5,846
Beed,,,Majalgaon,229,,113,9,0,0,9,1,EKNALOS OARRADANUS )ADAD( HSAKARP,,113,608,721,1,722
Beed,,,Majalgaon,229,,114,2,2,0,4,0,EKNALOS OARRADANUS )ADAD( HSAKARP,,114,249,363,0,363
Beed,,,Majalgaon,229,,115,5,3,0,8,2,EKNALOS OARRADANUS )ADAD( HSAKARP,,115,531,646,2,648
Beed,,,Majalgaon,229,,116,7,2,0,9,2,EKNALOS OARRADANUS )ADAD( HSAKARP,,116,338,454,2,456
Beed,,,Majalgaon,229,,117,5,1,0,6,0,EKNALOS OARRADANUS )ADAD( HSAKARP,,117,104,221,0,221
Beed,,,Majalgaon,229,,118,8,5,0,13,4,EKNALOS OARRADANUS )ADAD( HSAKARP,,118,566,684,4,688
Beed,,,Majalgaon,229,,119,5,1,0,6,3,EKNALOS OARRADANUS )ADAD( HSAKARP,,119,191,310,3,313
Beed,,,Majalgaon,229,,120,5,0,0,5,0,EKNALOS OARRADANUS )ADAD( HSAKARP,,120,273,393,0,393
Beed,,,Majalgaon,229,,121,3,1,0,4,1,EKNALOS OARRADANUS )ADAD( HSAKARP,,121,450,571,1,572
Beed,,,Majalgaon,229,,122,6,7,0,13,1,EKNALOS OARRADANUS )ADAD( HSAKARP,,122,576,698,1,699
Beed,,,Majalgaon,229,,123,8,11,0,19,3,EKNALOS OARRADANUS )ADAD( HSAKARP,,123,421,544,3,547
Beed,,,Majalgaon,229,,124,3,2,0,5,2,EKNALOS OARRADANUS )ADAD( HSAKARP,,124,410,534,2,536
Beed,,,Majalgaon,229,,125,16,6,0,22,1,EKNALOS OARRADANUS )ADAD( HSAKARP,,125,541,666,1,667
Beed,,,Majalgaon,229,,126,5,2,0,7,3,EKNALOS OARRADANUS )ADAD( HSAKARP,,126,528,654,3,657
Beed,,,Majalgaon,229,,127,13,0,0,13,4,EKNALOS OARRADANUS )ADAD( HSAKARP,,127,727,854,4,858
Beed,,,Majalgaon,229,,128,8,3,0,11,3,EKNALOS OARRADANUS )ADAD( HSAKARP,,128,725,853,3,856
Beed,,,Majalgaon,229,,129,5,0,0,5,2,EKNALOS OARRADANUS )ADAD( HSAKARP,,129,639,768,2,770
Beed,,,Majalgaon,229,,130,13,0,0,13,0,EKNALOS OARRADANUS )ADAD( HSAKARP,,130,481,611,0,611
Beed,,,Majalgaon,229,,131,21,0,0,21,3,EKNALOS OARRADANUS )ADAD( HSAKARP,,131,821,952,3,955
Beed,,,Majalgaon,229,,132,3,1,0,4,1,EKNALOS OARRADANUS )ADAD( HSAKARP,,132,381,513,1,514
Beed,,,Majalgaon,229,,133,9,1,0,10,2,EKNALOS OARRADANUS )ADAD( HSAKARP,,133,506,639,2,641
Beed,,,Majalgaon,229,,134,10,5,0,15,2,EKNALOS OARRADANUS )ADAD( HSAKARP,,134,506,640,2,642
Beed,,,Majalgaon,229,,135,5,1,0,6,0,EKNALOS OARRADANUS )ADAD( HSAKARP,,135,381,516,0,516
Beed,,,Majalgaon,229,,136,1,0,0,1,2,EKNALOS OARRADANUS )ADAD( HSAKARP,,136,389,525,2,527
Beed,,,Majalgaon,229,,137,0,1,0,1,0,EKNALOS OARRADANUS )ADAD( HSAKARP,,137,178,315,0,315
Beed,,,Majalgaon,229,,138,1,1,0,2,1,EKNALOS OARRADANUS )ADAD( HSAKARP,,138,177,315,1,316
Beed,,,Majalgaon,229,,139,4,2,0,6,2,EKNALOS OARRADANUS )ADAD( HSAKARP,,139,407,546,2,548
Beed,,,Majalgaon,229,,140,5,2,0,7,2,EKNALOS OARRADANUS )ADAD( HSAKARP,,140,451,591,2,593
Beed,,,Majalgaon,229,,141,7,2,0,9,0,EKNALOS OARRADANUS )ADAD( HSAKARP,,141,362,503,0,503
Beed,,,Majalgaon,229,,142,2,0,0,2,1,EKNALOS OARRADANUS )ADAD( HSAKARP,,142,285,427,1,428
Beed,,,Majalgaon,229,,143,2,1,0,3,1,EKNALOS OARRADANUS )ADAD( HSAKARP,,143,279,422,1,423
Beed,,,Majalgaon,229,,144,1,0,0,1,0,EKNALOS OARRADANUS )ADAD( HSAKARP,,144,208,352,0,352
Beed,,,Majalgaon,229,,145,3,1,0,4,0,EKNALOS OARRADANUS )ADAD( HSAKARP,,145,546,691,0,691
Beed,,,Majalgaon,229,,146,5,0,0,5,1,EKNALOS OARRADANUS )ADAD( HSAKARP,,146,465,611,1,612
Beed,,,Majalgaon,229,,147,3,1,0,4,0,EKNALOS OARRADANUS )ADAD( HSAKARP,,147,479,626,0,626
Beed,,,Majalgaon,229,,148,5,1,0,6,1,EKNALOS OARRADANUS )ADAD( HSAKARP,,148,613,761,1,762
Beed,,,Majalgaon,229,,149,3,1,0,4,0,EKNALOS OARRADANUS )ADAD( HSAKARP,,149,404,553,0,553
Beed,,,Majalgaon,229,,150,4,0,0,4,0,EKNALOS OARRADANUS )ADAD( HSAKARP,,150,289,439,0,439
Beed,,,Majalgaon,229,,151,2,0,0,2,1,EKNALOS OARRADANUS )ADAD( HSAKARP,,151,266,417,1,418
Beed,,,Majalgaon,229,,152,4,2,0,6,2,EKNALOS OARRADANUS )ADAD( HSAKARP,,152,444,596,2,598
Beed,,,Majalgaon,229,,153,10,3,0,13,2,EKNALOS OARRADANUS )ADAD( HSAKARP,,153,654,807,2,809
Beed,,,Majalgaon,229,,154,5,4,0,9,2,EKNALOS OARRADANUS )ADAD( HSAKARP,,154,616,770,2,772
Beed,,,Majalgaon,229,,155,7,1,0,8,2,EKNALOS OARRADANUS )ADAD( HSAKARP,,155,536,691,2,693
Beed,,,Majalgaon,229,,156,1,2,0,3,0,EKNALOS OARRADANUS )ADAD( HSAKARP,,156,305,461,0,461
Beed,,,Majalgaon,229,,157,3,0,0,3,0,EKNALOS OARRADANUS )ADAD( HSAKARP,,157,403,560,0,560
Beed,,,Majalgaon,229,,158,2,1,0,3,0,EKNALOS OARRADANUS )ADAD( HSAKARP,,158,441,599,0,599
Beed,,,Majalgaon,229,,159,4,4,0,8,1,EKNALOS OARRADANUS )ADAD( HSAKARP,,159,339,498,1,499
Beed,,,Majalgaon,229,,160,4,4,0,8,3,EKNALOS OARRADANUS )ADAD( HSAKARP,,160,624,784,3,787
Beed,,,Majalgaon,229,,161,2,2,0,4,0,EKNALOS OARRADANUS )ADAD( HSAKARP,,161,333,494,0,494
Beed,,,Majalgaon,229,,162,8,2,0,10,2,EKNALOS OARRADANUS )ADAD( HSAKARP,,162,585,747,2,749
Beed,,,Majalgaon,229,,163,2,1,0,3,2,EKNALOS OARRADANUS )ADAD( HSAKARP,,163,281,444,2,446
Beed,,,Majalgaon,229,,164,3,3,0,6,1,EKNALOS OARRADANUS )ADAD( HSAKARP,,164,338,502,1,503
Beed,,,Majalgaon,229,,165,9,1,0,10,2,EKNALOS OARRADANUS )ADAD( HSAKARP,,165,344,509,2,511
Beed,,,Majalgaon,229,,166,1,1,0,2,1,EKNALOS OARRADANUS )ADAD( HSAKARP,,166,380,546,1,547
Beed,,,Majalgaon,229,,167,5,0,0,5,0,EKNALOS OARRADANUS )ADAD( HSAKARP,,167,254,421,0,421
Beed,,,Majalgaon,229,,168,6,1,0,7,0,EKNALOS OARRADANUS )ADAD( HSAKARP,,168,511,679,0,679
Beed,,,Majalgaon,229,,169,8,0,0,8,0,EKNALOS OARRADANUS )ADAD( HSAKARP,,169,381,550,0,550
Beed,,,Majalgaon,229,,170,2,0,0,2,0,EKNALOS OARRADANUS )ADAD( HSAKARP,,170,187,357,0,357
Beed,,,Majalgaon,229,,171,5,1,0,6,2,EKNALOS OARRADANUS )ADAD( HSAKARP,,171,453,624,2,626
Beed,,,Majalgaon,229,,172,2,0,0,2,2,EKNALOS OARRADANUS )ADAD( HSAKARP,,172,422,594,2,596
Beed,,,Majalgaon,229,,173,4,0,0,4,0,EKNALOS OARRADANUS )ADAD( HSAKARP,,173,260,433,0,433
Beed,,,Majalgaon,229,,174,3,0,0,3,1,EKNALOS OARRADANUS )ADAD( HSAKARP,,174,633,807,1,808
Beed,,,Majalgaon,229,,175,2,1,0,3,0,EKNALOS OARRADANUS )ADAD( HSAKARP,,175,257,432,0,432
Beed,,,Majalgaon,229,,176,1,0,0,1,1,EKNALOS OARRADANUS )ADAD( HSAKARP,,176,642,818,1,819
Beed,,,Majalgaon,229,,177,3,4,0,7,0,EKNALOS OARRADANUS )ADAD( HSAKARP,,177,433,610,0,610
Beed,,,Majalgaon,229,,178,3,1,0,4,3,EKNALOS OARRADANUS )ADAD( HSAKARP,,178,454,632,3,635
Beed,,,Majalgaon,229,,179,4,1,0,5,0,EKNALOS OARRADANUS )ADAD( HSAKARP,,179,354,533,0,533
Beed,,,Majalgaon,229,,180,3,1,0,4,0,EKNALOS OARRADANUS )ADAD( HSAKARP,,180,422,602,0,602
Beed,,,Majalgaon,229,,181,7,2,0,9,1,EKNALOS OARRADANUS )ADAD( HSAKARP,,181,477,658,1,659
Beed,,,Majalgaon,229,,183,4,0,0,4,2,EKNALOS OARRADANUS )ADAD( HSAKARP,,183,535,718,2,720
Beed,,,Majalgaon,229,,184,2,0,0,2,1,EKNALOS OARRADANUS )ADAD( HSAKARP,,184,344,528,1,529
Beed,,,Majalgaon,229,,185,2,0,0,2,0,EKNALOS OARRADANUS )ADAD( HSAKARP,,185,208,393,0,393
Beed,,,Majalgaon,229,,186,10,1,0,11,4,EKNALOS OARRADANUS )ADAD( HSAKARP,,186,588,774,4,778
Beed,,,Majalgaon,229,,187,4,2,0,6,9,EKNALOS OARRADANUS )ADAD( HSAKARP,,187,432,619,9,628
Beed,,,Majalgaon,229,,188,4,1,0,5,1,EKNALOS OARRADANUS )ADAD( HSAKARP,,188,170,358,1,359
Beed,,,Majalgaon,229,,189,2,2,0,4,1,EKNALOS OARRADANUS )ADAD( HSAKARP,,189,266,455,1,456
Beed,,,Majalgaon,229,,190,0,0,0,0,0,EKNALOS OARRADANUS )ADAD( HSAKARP,,190,133,323,0,323
Beed,,,Majalgaon,229,,191,2,1,0,3,0,EKNALOS OARRADANUS )ADAD( HSAKARP,,191,362,553,0,553
Beed,,,Majalgaon,229,,192,4,2,0,6,0,EKNALOS OARRADANUS )ADAD( HSAKARP,,192,323,515,0,515
Beed,,,Majalgaon,229,,193,7,1,0,8,2,EKNALOS OARRADANUS )ADAD( HSAKARP,,193,459,652,2,654
Beed,,,Majalgaon,229,,194,1,1,0,2,0,EKNALOS OARRADANUS )ADAD( HSAKARP,,194,193,387,0,387
Beed,,,Majalgaon,229,,195,3,2,0,5,1,EKNALOS OARRADANUS )ADAD( HSAKARP,,195,626,821,1,822
Beed,,,Majalgaon,229,,196,4,2,0,6,0,EKNALOS OARRADANUS )ADAD( HSAKARP,,196,318,514,0,514
Beed,,,Majalgaon,229,,197,2,2,0,4,0,EKNALOS OARRADANUS )ADAD( HSAKARP,,197,231,428,0,428
Beed,,,Majalgaon,229,,198,4,1,0,5,0,EKNALOS OARRADANUS )ADAD( HSAKARP,,198,267,465,0,465
Beed,,,Majalgaon,229,,199,4,1,0,5,0,EKNALOS OARRADANUS )ADAD( HSAKARP,,199,426,625,0,625
Beed,,,Majalgaon,229,,200,7,0,0,7,2,EKNALOS OARRADANUS )ADAD( HSAKARP,,200,266,466,2,468
Beed,,,Majalgaon,229,,201,4,4,0,8,2,EKNALOS OARRADANUS )ADAD( HSAKARP,,201,355,556,2,558
Beed,,,Majalgaon,229,,202,8,0,0,8,0,EKNALOS OARRADANUS )ADAD( HSAKARP,,202,306,508,0,508
Beed,,,Majalgaon,229,,203,10,2,0,12,3,EKNALOS OARRADANUS )ADAD( HSAKARP,,203,385,588,3,591
Beed,,,Majalgaon,229,,204,7,0,0,7,4,EKNALOS OARRADANUS )ADAD( HSAKARP,,204,477,681,4,685
Beed,,,Majalgaon,229,,205,1,2,0,3,0,EKNALOS OARRADANUS )ADAD( HSAKARP,,205,479,684,0,684
Beed,,,Majalgaon,229,,206,11,3,0,14,6,EKNALOS OARRADANUS )ADAD( HSAKARP,,206,593,799,6,805
Beed,,,Majalgaon,229,,207,10,2,0,12,1,EKNALOS OARRADANUS )ADAD( HSAKARP,,207,304,511,1,512
Beed,,,Majalgaon,229,,208,6,0,0,6,0,EKNALOS OARRADANUS )ADAD( HSAKARP,,208,321,529,0,529
Beed,,,Majalgaon,229,,209,1,1,0,2,0,EKNALOS OARRADANUS )ADAD( HSAKARP,,209,276,485,0,485
Beed,,,Majalgaon,229,,210,5,2,0,7,2,EKNALOS OARRADANUS )ADAD( HSAKARP,,210,449,659,2,661
Beed,,,Majalgaon,229,,211,9,4,0,13,7,EKNALOS OARRADANUS )ADAD( HSAKARP,,211,369,580,7,587
Beed,,,Majalgaon,229,,212,0,1,0,1,0,EKNALOS OARRADANUS )ADAD( HSAKARP,,212,438,650,0,650
Beed,,,Majalgaon,229,,213,5,0,0,5,2,EKNALOS OARRADANUS )ADAD( HSAKARP,,213,366,579,2,581
Beed,,,Majalgaon,229,,214,7,0,0,7,1,EKNALOS OARRADANUS )ADAD( HSAKARP,,214,539,753,1,754
Beed,,,Majalgaon,229,,215,5,1,0,6,1,EKNALOS OARRADANUS )ADAD( HSAKARP,,215,500,715,1,716
Beed,,,Majalgaon,229,,216,2,0,0,2,0,EKNALOS OARRADANUS )ADAD( HSAKARP,,216,195,411,0,411
Beed,,,Majalgaon,229,,217,3,2,0,5,0,EKNALOS OARRADANUS )ADAD( HSAKARP,,217,384,601,0,601
Beed,,,Majalgaon,229,,218,4,1,0,5,1,EKNALOS OARRADANUS )ADAD( HSAKARP,,218,447,665,1,666
Beed,,,Majalgaon,229,,219,1,0,0,1,1,EKNALOS OARRADANUS )ADAD( HSAKARP,,219,277,496,1,497
Beed,,,Majalgaon,229,,220,1,1,0,2,0,EKNALOS OARRADANUS )ADAD( HSAKARP,,220,283,503,0,503
Beed,,,Majalgaon,229,,221,2,0,0,2,0,EKNALOS OARRADANUS )ADAD( HSAKARP,,221,219,440,0,440
Beed,,,Majalgaon,229,,222,0,1,0,1,0,EKNALOS OARRADANUS )ADAD( HSAKARP,,222,717,939,0,939
Beed,,,Majalgaon,229,,223,3,0,0,3,0,EKNALOS OARRADANUS )ADAD( HSAKARP,,223,792,1015,0,1015
Beed,,,Majalgaon,229,,224,3,3,0,6,2,EKNALOS OARRADANUS )ADAD( HSAKARP,,224,633,857,2,859
Beed,,,Majalgaon,229,,225,3,0,0,3,1,EKNALOS OARRADANUS )ADAD( HSAKARP,,225,766,991,1,992
Beed,,,Majalgaon,229,,226,1,0,0,1,3,EKNALOS OARRADANUS )ADAD( HSAKARP,,226,727,953,3,956
Beed,,,Majalgaon,229,,227,7,0,0,7,3,EKNALOS OARRADANUS )ADAD( HSAKARP,,227,652,879,3,882
Beed,,,Majalgaon,229,,228,2,1,0,3,0,EKNALOS OARRADANUS )ADAD( HSAKARP,,228,647,875,0,875
Beed,,,Majalgaon,229,,229,0,2,0,2,1,EKNALOS OARRADANUS )ADAD( HSAKARP,,229,556,785,1,786
Beed,,,Majalgaon,229,,230,2,0,0,2,0,EKNALOS OARRADANUS )ADAD( HSAKARP,,230,475,705,0,705
Beed,,,Majalgaon,229,,231,8,0,0,8,1,EKNALOS OARRADANUS )ADAD( HSAKARP,,231,723,954,1,955
Beed,,,Majalgaon,229,,232,4,0,0,4,0,EKNALOS OARRADANUS )ADAD( HSAKARP,,232,606,838,0,838
Beed,,,Majalgaon,229,,233,0,1,0,1,2,EKNALOS OARRADANUS )ADAD( HSAKARP,,233,358,591,2,593
Beed,,,Majalgaon,229,,234,1,0,0,1,0,EKNALOS OARRADANUS )ADAD( HSAKARP,,234,480,714,0,714
Beed,,,Majalgaon,229,,235,4,1,0,5,2,EKNALOS OARRADANUS )ADAD( HSAKARP,,235,279,514,2,516
Beed,,,Majalgaon,229,,236,6,1,0,7,2,EKNALOS OARRADANUS )ADAD( HSAKARP,,236,366,602,2,604
Beed,,,Majalgaon,229,,237,5,0,0,5,0,EKNALOS OARRADANUS )ADAD( HSAKARP,,237,525,762,0,762
Beed,,,Majalgaon,229,,238,2,0,0,2,2,EKNALOS OARRADANUS )ADAD( HSAKARP,,238,421,659,2,661
Beed,,,Majalgaon,229,,239,2,1,0,3,0,EKNALOS OARRADANUS )ADAD( HSAKARP,,239,311,550,0,550
Beed,,,Majalgaon,229,,240,2,2,0,4,0,EKNALOS OARRADANUS )ADAD( HSAKARP,,240,504,744,0,744
Beed,,,Majalgaon,229,,241,7,6,0,13,2,EKNALOS OARRADANUS )ADAD( HSAKARP,,241,520,761,2,763
Beed,,,Majalgaon,229,,242,6,2,0,8,0,EKNALOS OARRADANUS )ADAD( HSAKARP,,242,442,684,0,684
Beed,,,Majalgaon,229,,243,4,3,0,7,1,EKNALOS OARRADANUS )ADAD( HSAKARP,,243,469,712,1,713
Beed,,,Majalgaon,229,,244,9,1,0,10,0,EKNALOS OARRADANUS )ADAD( HSAKARP,,244,545,789,0,789
Beed,,,Majalgaon,229,,245,4,0,0,4,1,EKNALOS OARRADANUS )ADAD( HSAKARP,,245,324,569,1,570
Beed,,,Majalgaon,229,,246,1,1,0,2,1,EKNALOS OARRADANUS )ADAD( HSAKARP,,246,506,752,1,753
Beed,,,Majalgaon,229,,247,2,0,0,2,1,EKNALOS OARRADANUS )ADAD( HSAKARP,,247,545,792,1,793
Beed,,,Majalgaon,229,,248,1,0,0,1,0,EKNALOS OARRADANUS )ADAD( HSAKARP,,248,471,719,0,719
Beed,,,Majalgaon,229,,249,9,3,0,12,0,EKNALOS OARRADANUS )ADAD( HSAKARP,,249,488,737,0,737
Beed,,,Majalgaon,229,,250,5,0,0,5,1,EKNALOS OARRADANUS )ADAD( HSAKARP,,250,294,544,1,545
Beed,,,Majalgaon,229,,251,0,0,0,0,0,EKNALOS OARRADANUS )ADAD( HSAKARP,,251,342,593,0,593
Beed,,,Majalgaon,229,,252,0,0,0,0,1,EKNALOS OARRADANUS )ADAD( HSAKARP,,252,469,721,1,722
Beed,,,Majalgaon,229,,253,7,1,0,8,0,EKNALOS OARRADANUS )ADAD( HSAKARP,,253,472,725,0,725
Beed,,,Majalgaon,229,,254,1,1,0,2,0,EKNALOS OARRADANUS )ADAD( HSAKARP,,254,435,689,0,689
Beed,,,Majalgaon,229,,255,0,0,0,0,0,EKNALOS OARRADANUS )ADAD( HSAKARP,,255,429,684,0,684
Beed,,,Majalgaon,229,,256,1,0,0,1,0,EKNALOS OARRADANUS )ADAD( HSAKARP,,256,310,566,0,566
Beed,,,Majalgaon,229,,257,3,2,0,5,1,EKNALOS OARRADANUS )ADAD( HSAKARP,,257,506,763,1,764
Beed,,,Majalgaon,229,,258,2,2,0,4,0,EKNALOS OARRADANUS )ADAD( HSAKARP,,258,319,577,0,577
Beed,,,Majalgaon,229,,259,1,0,0,1,0,EKNALOS OARRADANUS )ADAD( HSAKARP,,259,294,553,0,553
Beed,,,Majalgaon,229,,260,3,0,0,3,1,EKNALOS OARRADANUS )ADAD( HSAKARP,,260,418,678,1,679
Beed,,,Majalgaon,229,,261,0,0,0,0,0,EKNALOS OARRADANUS )ADAD( HSAKARP,,261,528,789,0,789
Beed,,,Majalgaon,229,,262,7,1,0,8,3,EKNALOS OARRADANUS )ADAD( HSAKARP,,262,488,750,3,753
Beed,,,Majalgaon,229,,263,6,1,0,7,1,EKNALOS OARRADANUS )ADAD( HSAKARP,,263,267,530,1,531
Beed,,,Majalgaon,229,,264,0,0,0,0,0,EKNALOS OARRADANUS )ADAD( HSAKARP,,264,278,542,0,542
Beed,,,Majalgaon,229,,265,5,1,0,6,0,EKNALOS OARRADANUS )ADAD( HSAKARP,,265,393,658,0,658
Beed,,,Majalgaon,229,,266,7,2,0,9,2,EKNALOS OARRADANUS )ADAD( HSAKARP,,266,303,569,2,571
Beed,,,Majalgaon,229,,267,3,0,0,3,2,EKNALOS OARRADANUS )ADAD( HSAKARP,,267,300,567,2,569
Beed,,,Majalgaon,229,,268,6,4,0,10,2,EKNALOS OARRADANUS )ADAD( HSAKARP,,268,422,690,2,692
Beed,,,Majalgaon,229,,269,7,1,0,8,2,EKNALOS OARRADANUS )ADAD( HSAKARP,,269,295,564,2,566
Beed,,,Majalgaon,229,,270,4,0,0,4,1,EKNALOS OARRADANUS )ADAD( HSAKARP,,270,669,939,1,940
Beed,,,Majalgaon,229,,271,0,1,0,1,0,EKNALOS OARRADANUS )ADAD( HSAKARP,,271,479,750,0,750
Beed,,,Majalgaon,229,,272,5,1,0,6,1,EKNALOS OARRADANUS )ADAD( HSAKARP,,272,571,843,1,844
Beed,,,Majalgaon,229,,274,1,0,0,1,0,EKNALOS OARRADANUS )ADAD( HSAKARP,,274,281,555,0,555
Beed,,,Majalgaon,229,,275,2,0,0,2,0,EKNALOS OARRADANUS )ADAD( HSAKARP,,275,503,778,0,778
Beed,,,Majalgaon,229,,276,5,1,0,6,1,EKNALOS OARRADANUS )ADAD( HSAKARP,,276,546,822,1,823
Beed,,,Majalgaon,229,,277,0,0,0,0,1,EKNALOS OARRADANUS )ADAD( HSAKARP,,277,409,686,1,687
Beed,,,Majalgaon,229,,278,0,2,0,2,1,EKNALOS OARRADANUS )ADAD( HSAKARP,,278,398,676,1,677
Beed,,,Majalgaon,229,,279,7,1,0,8,2,EKNALOS OARRADANUS )ADAD( HSAKARP,,279,425,704,2,706
Beed,,,Majalgaon,229,,280,13,0,0,13,3,EKNALOS OARRADANUS )ADAD( HSAKARP,,280,439,719,3,722
Beed,,,Majalgaon,229,,281,3,1,0,4,0,EKNALOS OARRADANUS )ADAD( HSAKARP,,281,297,578,0,578
Beed,,,Majalgaon,229,,282,7,1,0,8,2,EKNALOS OARRADANUS )ADAD( HSAKARP,,282,557,839,2,841
Beed,,,Majalgaon,229,,283,2,0,0,2,0,EKNALOS OARRADANUS )ADAD( HSAKARP,,283,400,683,0,683
Beed,,,Majalgaon,229,,284,9,1,0,10,2,EKNALOS OARRADANUS )ADAD( HSAKARP,,284,488,772,2,774
Beed,,,Majalgaon,229,,285,10,0,0,10,1,EKNALOS OARRADANUS )ADAD( HSAKARP,,285,417,702,1,703
Beed,,,Majalgaon,229,,286,3,1,0,4,1,EKNALOS OARRADANUS )ADAD( HSAKARP,,286,361,647,1,648
Beed,,,Majalgaon,229,,287,3,0,0,3,1,EKNALOS OARRADANUS )ADAD( HSAKARP,,287,402,689,1,690
Beed,,,Majalgaon,229,,288,1,0,0,1,0,EKNALOS OARRADANUS )ADAD( HSAKARP,,288,33,321,0,321
Beed,,,Majalgaon,229,,289,3,2,0,5,0,EKNALOS OARRADANUS )ADAD( HSAKARP,,289,387,676,0,676
Beed,,,Majalgaon,229,,290,3,0,0,3,1,EKNALOS OARRADANUS )ADAD( HSAKARP,,290,182,472,1,473
Beed,,,Majalgaon,229,,291,1,0,0,1,0,EKNALOS OARRADANUS )ADAD( HSAKARP,,291,172,463,0,463
Beed,,,Majalgaon,229,,292,0,0,0,0,0,EKNALOS OARRADANUS )ADAD( HSAKARP,,292,458,750,0,750
Beed,,,Majalgaon,229,,293,4,1,0,5,0,EKNALOS OARRADANUS )ADAD( HSAKARP,,293,289,582,0,582
Beed,,,Majalgaon,229,,294,2,0,0,2,0,EKNALOS OARRADANUS )ADAD( HSAKARP,,294,447,741,0,741
Beed,,,Majalgaon,229,,295,0,0,0,0,1,EKNALOS OARRADANUS )ADAD( HSAKARP,,295,296,591,1,592
Beed,,,Majalgaon,229,,296,2,0,0,2,0,EKNALOS OARRADANUS )ADAD( HSAKARP,,296,273,569,0,569
Beed,,,Majalgaon,229,,297,2,0,0,2,3,EKNALOS OARRADANUS )ADAD( HSAKARP,,297,222,519,3,522
Beed,,,Majalgaon,229,,298,3,0,0,3,3,EKNALOS OARRADANUS )ADAD( HSAKARP,,298,264,562,3,565
Beed,,,Majalgaon,229,,299,0,0,0,0,0,EKNALOS OARRADANUS )ADAD( HSAKARP,,299,237,536,0,536
Beed,,,Majalgaon,229,,300,1,0,0,1,2,EKNALOS OARRADANUS )ADAD( HSAKARP,,300,158,458,2,460
Beed,,,Majalgaon,229,,301,0,1,0,1,0,EKNALOS OARRADANUS )ADAD( HSAKARP,,301,111,412,0,412
Beed,,,Majalgaon,229,,302,0,0,0,0,0,EKNALOS OARRADANUS )ADAD( HSAKARP,,302,117,419,0,419
Beed,,,Majalgaon,229,,303,0,0,0,0,0,EKNALOS OARRADANUS )ADAD( HSAKARP,,303,21,324,0,324
Beed,,,Majalgaon,229,,304,7,1,0,8,1,EKNALOS OARRADANUS )ADAD( HSAKARP,,304,456,760,1,761
Beed,,,Majalgaon,229,,305,2,0,0,2,0,EKNALOS OARRADANUS )ADAD( HSAKARP,,305,172,477,0,477
Beed,,,Majalgaon,229,,306,2,1,0,3,0,EKNALOS OARRADANUS )ADAD( HSAKARP,,306,255,561,0,561
Beed,,,Majalgaon,229,,307,0,0,0,0,0,EKNALOS OARRADANUS )ADAD( HSAKARP,,307,458,765,0,765
Beed,,,Majalgaon,229,,308,2,0,0,2,0,EKNALOS OARRADANUS )ADAD( HSAKARP,,308,229,537,0,537
Beed,,,Majalgaon,229,,309,5,2,0,7,0,EKNALOS OARRADANUS )ADAD( HSAKARP,,309,363,672,0,672
Beed,,,Majalgaon,229,,310,4,0,0,4,0,EKNALOS OARRADANUS )ADAD( HSAKARP,,310,380,690,0,690
Beed,,,Majalgaon,229,,311,1,3,0,4,4,EKNALOS OARRADANUS )ADAD( HSAKARP,,311,400,711,4,715
Beed,,,Majalgaon,229,,312,0,0,0,0,0,EKNALOS OARRADANUS )ADAD( HSAKARP,,312,385,697,0,697
Beed,,,Majalgaon,229,,313,1,1,0,2,0,EKNALOS OARRADANUS )ADAD( HSAKARP,,313,334,647,0,647
Beed,,,Majalgaon,229,,314,3,0,0,3,2,EKNALOS OARRADANUS )ADAD( HSAKARP,,314,374,688,2,690
Beed,,,Majalgaon,229,,315,3,2,0,5,2,EKNALOS OARRADANUS )ADAD( HSAKARP,,315,292,607,2,609
Beed,,,Majalgaon,229,,316,0,0,0,0,0,EKNALOS OARRADANUS )ADAD( HSAKARP,,316,242,558,0,558
Beed,,,Majalgaon,229,,317,0,2,0,2,0,EKNALOS OARRADANUS )ADAD( HSAKARP,,317,290,607,0,607
Beed,,,Majalgaon,229,,318,0,1,0,1,0,EKNALOS OARRADANUS )ADAD( HSAKARP,,318,371,689,0,689
Beed,,,Majalgaon,229,,319,2,0,0,2,0,EKNALOS OARRADANUS )ADAD( HSAKARP,,319,330,649,0,649
Beed,,,Majalgaon,229,,320,1,1,0,2,0,EKNALOS OARRADANUS )ADAD( HSAKARP,,320,263,583,0,583
Beed,,,Majalgaon,229,,321,0,0,0,0,0,EKNALOS OARRADANUS )ADAD( HSAKARP,,321,151,472,0,472
Beed,,,Majalgaon,229,,322,0,2,0,2,0,EKNALOS OARRADANUS )ADAD( HSAKARP,,322,338,660,0,660
Beed,,,Majalgaon,229,,323,1,2,0,3,0,EKNALOS OARRADANUS )ADAD( HSAKARP,,323,284,607,0,607
Beed,,,Majalgaon,229,,324,1,1,0,2,0,EKNALOS OARRADANUS )ADAD( HSAKARP,,324,275,599,0,599
Beed,,,Majalgaon,229,,325,0,2,0,2,0,EKNALOS OARRADANUS )ADAD( HSAKARP,,325,212,537,0,537
Beed,,,Majalgaon,229,,326,2,0,0,2,0,EKNALOS OARRADANUS )ADAD( HSAKARP,,326,102,428,0,428
Beed,,,Majalgaon,229,,327,4,2,0,6,0,EKNALOS OARRADANUS )ADAD( HSAKARP,,327,414,741,0,741
Beed,,,Majalgaon,229,,328,0,0,0,0,1,EKNALOS OARRADANUS )ADAD( HSAKARP,,328,107,435,1,436
Beed,,,Majalgaon,229,,329,3,1,0,4,0,EKNALOS OARRADANUS )ADAD( HSAKARP,,329,422,751,0,751
Beed,,,Majalgaon,229,,330,0,0,0,0,0,EKNALOS OARRADANUS )ADAD( HSAKARP,,330,527,857,0,857
Beed,,,Majalgaon,229,,331,1,1,0,2,0,EKNALOS OARRADANUS )ADAD( HSAKARP,,331,609,940,0,940
Beed,,,Majalgaon,229,,332,0,0,0,0,0,EKNALOS OARRADANUS )ADAD( HSAKARP,,332,145,477,0,477
Beed,,,Majalgaon,229,,333,1,1,0,2,0,EKNALOS OARRADANUS )ADAD( HSAKARP,,333,197,530,0,530
Beed,,,Majalgaon,229,,334,0,1,0,1,0,EKNALOS OARRADANUS )ADAD( HSAKARP,,334,260,594,0,594
Beed,,,Majalgaon,229,,335,0,1,0,1,0,EKNALOS OARRADANUS )ADAD( HSAKARP,,335,170,505,0,505
Beed,,,Majalgaon,229,,336,0,0,0,0,0,EKNALOS OARRADANUS )ADAD( HSAKARP,,336,461,797,0,797
Beed,,,Majalgaon,229,,337,0,0,0,0,0,EKNALOS OARRADANUS )ADAD( HSAKARP,,337,371,708,0,708
Beed,,,Majalgaon,229,,338,2,0,0,2,0,EKNALOS OARRADANUS )ADAD( HSAKARP,,338,182,520,0,520
Beed,,,Majalgaon,229,,339,8,3,0,11,2,EKNALOS OARRADANUS )ADAD( HSAKARP,,339,423,762,2,764
Beed,,,Majalgaon,229,,340,4,2,0,6,2,EKNALOS OARRADANUS )ADAD( HSAKARP,,340,314,654,2,656
Beed,,,Majalgaon,229,,341,3,2,0,5,0,EKNALOS OARRADANUS )ADAD( HSAKARP,,341,465,806,0,806
Beed,,,Majalgaon,229,,342,5,0,0,5,1,EKNALOS OARRADANUS )ADAD( HSAKARP,,342,417,759,1,760
Beed,,,Majalgaon,229,,343,5,0,0,5,1,EKNALOS OARRADANUS )ADAD( HSAKARP,,343,333,676,1,677
Beed,,,Majalgaon,229,,344,3,0,0,3,0,EKNALOS OARRADANUS )ADAD( HSAKARP,,344,197,541,0,541
Beed,,,Majalgaon,229,,345,0,2,0,2,0,EKNALOS OARRADANUS )ADAD( HSAKARP,,345,196,541,0,541
Beed,,,Majalgaon,229,,346,0,0,0,0,0,EKNALOS OARRADANUS )ADAD( HSAKARP,,346,238,584,0,584
Beed,,,Majalgaon,229,,347,4,2,0,6,0,EKNALOS OARRADANUS )ADAD( HSAKARP,,347,340,687,0,687
Beed,,,Majalgaon,229,,348,6,1,0,7,1,EKNALOS OARRADANUS )ADAD( HSAKARP,,348,397,745,1,746
Beed,,,Majalgaon,229,,349,0,4,0,4,1,EKNALOS OARRADANUS )ADAD( HSAKARP,,349,118,467,1,468
Beed,,,Majalgaon,229,,350,0,0,0,0,0,EKNALOS OARRADANUS )ADAD( HSAKARP,,350,140,490,0,490
Beed,,,Majalgaon,229,,351,0,0,0,0,0,EKNALOS OARRADANUS )ADAD( HSAKARP,,351,100,451,0,451
Beed,,,Majalgaon,229,,352,0,0,0,0,2,EKNALOS OARRADANUS )ADAD( HSAKARP,,352,97,449,2,451
Beed,,,Majalgaon,229,,353,0,0,0,0,0,EKNALOS OARRADANUS )ADAD( HSAKARP,,353,80,433,0,433
Beed,,,Majalgaon,229,,354,1,0,0,1,0,EKNALOS OARRADANUS )ADAD( HSAKARP,,354,187,541,0,541
Beed,,,Majalgaon,229,,355,1,1,0,2,0,EKNALOS OARRADANUS )ADAD( HSAKARP,,355,114,469,0,469
Beed,,,Majalgaon,229,,356,2,0,0,2,0,EKNALOS OARRADANUS )ADAD( HSAKARP,,356,231,587,0,587
Beed,,,Majalgaon,229,,357,6,0,0,6,0,EKNALOS OARRADANUS )ADAD( HSAKARP,,357,275,632,0,632
Beed,,,Majalgaon,229,,358,1,0,0,1,0,EKNALOS OARRADANUS )ADAD( HSAKARP,,358,74,432,0,432
Beed,,,Majalgaon,229,,359,3,0,0,3,3,EKNALOS OARRADANUS )ADAD( HSAKARP,,359,111,470,3,473
Beed,,,Majalgaon,229,,360,0,0,0,0,1,EKNALOS OARRADANUS )ADAD( HSAKARP,,360,121,481,1,482
Beed,,,Majalgaon,229,,361,0,0,0,0,1,EKNALOS OARRADANUS )ADAD( HSAKARP,,361,147,508,1,509
Beed,,,Majalgaon,229,,362,0,0,0,0,0,EKNALOS OARRADANUS )ADAD( HSAKARP,,362,245,607,0,607
Beed,,,Majalgaon,229,,363,0,0,0,0,0,EKNALOS OARRADANUS )ADAD( HSAKARP,,363,272,635,0,635
Beed,,,Majalgaon,229,,365,0,0,0,0,0,EKNALOS OARRADANUS )ADAD( HSAKARP,,365,189,554,0,554
Beed,,,Majalgaon,229,,366,5,0,0,5,0,EKNALOS OARRADANUS )ADAD( HSAKARP,,366,278,644,0,644
Beed,,,Majalgaon,229,,367,2,0,0,2,1,EKNALOS OARRADANUS )ADAD( HSAKARP,,367,333,700,1,701
Beed,,,Majalgaon,229,,368,1,0,0,1,0,EKNALOS OARRADANUS )ADAD( HSAKARP,,368,151,519,0,519
Beed,,,Majalgaon,229,,369,3,1,0,4,0,EKNALOS OARRADANUS )ADAD( HSAKARP,,369,332,701,0,701
Beed,,,Majalgaon,229,,370,2,1,0,3,2,EKNALOS OARRADANUS )ADAD( HSAKARP,,370,435,805,2,807
Beed,,,Majalgaon,229,,371,8,2,0,10,4,EKNALOS OARRADANUS )ADAD( HSAKARP,,371,367,738,4,742
Beed,,,Majalgaon,229,,372,3,0,0,3,0,EKNALOS OARRADANUS )ADAD( HSAKARP,,372,188,560,0,560
Beed,,,Majalgaon,229,,373,5,1,0,6,0,EKNALOS OARRADANUS )ADAD( HSAKARP,,373,180,553,0,553
Beed,,,Majalgaon,229,,374,1,0,0,1,2,EKNALOS OARRADANUS )ADAD( HSAKARP,,374,196,570,2,572
Beed,,,Majalgaon,229,,375,3,0,0,3,1,EKNALOS OARRADANUS )ADAD( HSAKARP,,375,320,695,1,696
Beed,,,Majalgaon,229,,376,2,0,0,2,0,EKNALOS OARRADANUS )ADAD( HSAKARP,,376,214,590,0,590
Beed,,,Majalgaon,229,,377,14,5,0,19,1,EKNALOS OARRADANUS )ADAD( HSAKARP,,377,376,753,1,754
Beed,,,Majalgaon,229,,378,6,0,0,6,2,EKNALOS OARRADANUS )ADAD( HSAKARP,,378,428,806,2,808
Beed,,,Majalgaon,229,,379,7,3,0,10,9,EKNALOS OARRADANUS )ADAD( HSAKARP,,379,480,859,9,868
Beed,,,Majalgaon,229,,380,5,2,0,7,0,EKNALOS OARRADANUS )ADAD( HSAKARP,,380,174,554,0,554
Beed,,,Majalgaon,229,,381,5,0,0,5,2,EKNALOS OARRADANUS )ADAD( HSAKARP,,381,301,682,2,684
Beed,,,Majalgaon,229,,382,3,1,0,4,0,EKNALOS OARRADANUS )ADAD( HSAKARP,,382,199,581,0,581
Beed,,,Majalgaon,229,,383,4,0,0,4,3,EKNALOS OARRADANUS )ADAD( HSAKARP,,383,195,578,3,581
Beed,,,Majalgaon,229,,384,1,0,0,1,0,EKNALOS OARRADANUS )ADAD( HSAKARP,,384,396,780,0,780
Beed,,,Majalgaon,229,,385,0,0,0,0,0,EKNALOS OARRADANUS )ADAD( HSAKARP,,385,40,425,0,425
Beed,,,Majalgaon,229,,386,0,0,0,0,1,EKNALOS OARRADANUS )ADAD( HSAKARP,,386,429,815,1,816
Beed,,,Majalgaon,229,,387,1,0,0,1,0,EKNALOS OARRADANUS )ADAD( HSAKARP,,387,205,592,0,592
Beed,,,Majalgaon,229,,388,5,3,0,8,0,EKNALOS OARRADANUS )ADAD( HSAKARP,,388,228,616,0,616
Beed,,,Majalgaon,229,,389,1,1,0,2,0,EKNALOS OARRADANUS )ADAD( HSAKARP,,389,188,577,0,577
Beed,,,Majalgaon,229,,390,4,1,0,5,1,EKNALOS OARRADANUS )ADAD( HSAKARP,,390,117,507,1,508
Beed,,,Majalgaon,229,,391,5,1,0,6,0,EKNALOS OARRADANUS )ADAD( HSAKARP,,391,237,628,0,628
Beed,,,Majalgaon,229,,392,5,2,0,7,0,EKNALOS OARRADANUS )ADAD( HSAKARP,,392,538,930,0,930
Beed,,,Majalgaon,229,,393,1,1,0,2,0,EKNALOS OARRADANUS )ADAD( HSAKARP,,393,618,1011,0,1011
TOTAL,,,,,,,1501,411,0,1912,446,,,76511,150291,226802,446,227248
