District Name,District No,Jilha,Constituency Name,Constituency No,Total No. of Electors,Serial Poll,Total No. Valid Votes,No. of Rejected Votes,NOTA,Total,No. of Tendered Votes,Elected Person Name,Party Name of Elected Person,No. of Valid Votes Cast in Favour of Elected Person,Other Candidate Votes,Total EVM Votes,Total Postal ballot votes,Total Votes Polled
Bhandara,,,Tumsar,60,,1,13,14,0,27,16,Charan Sovinda Waghmare,,2,76,78,16,94
Bhandara,,,Tumsar,60,,1,0,5,0,5,5,Charan Sovinda Waghmare,,423,358,781,5,786
Bhandara,,,Tumsar,60,,2,0,1,0,1,2,Charan Sovinda Waghmare,,530,250,780,2,782
Bhandara,,,Tumsar,60,,3,1,1,0,2,3,Charan Sovinda Waghmare,,196,236,432,3,435
Bhandara,,,Tumsar,60,,4,0,0,0,0,3,Charan Sovinda Waghmare,,171,229,400,3,403
Bhandara,,,Tumsar,60,,5,0,1,0,1,5,Charan Sovinda Waghmare,,541,277,818,5,823
Bhandara,,,Tumsar,60,,6,1,1,0,2,14,Charan Sovinda Waghmare,,391,202,593,14,607
Bhandara,,,Tumsar,60,,7,0,1,0,1,0,Charan Sovinda Waghmare,,243,70,313,0,313
Bhandara,,,Tumsar,60,,8,0,5,0,5,1,Charan Sovinda Waghmare,,357,140,497,1,498
Bhandara,,,Tumsar,60,,9,1,4,0,5,1,Charan Sovinda Waghmare,,333,128,461,1,462
Bhandara,,,Tumsar,60,,10,0,0,0,0,5,Charan Sovinda Waghmare,,292,140,432,5,437
Bhandara,,,Tumsar,60,,11,0,0,0,0,0,Charan Sovinda Waghmare,,385,121,506,0,506
Bhandara,,,Tumsar,60,,12,1,7,0,8,0,Charan Sovinda Waghmare,,409,116,525,0,525
Bhandara,,,Tumsar,60,,13,0,2,0,2,3,Charan Sovinda Waghmare,,415,142,557,3,560
Bhandara,,,Tumsar,60,,14,0,0,0,0,0,Charan Sovinda Waghmare,,300,166,466,0,466
Bhandara,,,Tumsar,60,,15,2,5,0,7,2,Charan Sovinda Waghmare,,378,143,521,2,523
Bhandara,,,Tumsar,60,,16,1,0,0,1,3,Charan Sovinda Waghmare,,224,218,442,3,445
Bhandara,,,Tumsar,60,,17,0,1,0,1,4,Charan Sovinda Waghmare,,586,246,832,4,836
Bhandara,,,Tumsar,60,,18,1,1,0,2,2,Charan Sovinda Waghmare,,370,239,609,2,611
Bhandara,,,Tumsar,60,,19,0,0,0,0,1,Charan Sovinda Waghmare,,370,86,456,1,457
Bhandara,,,Tumsar,60,,20,0,0,0,0,1,Charan Sovinda Waghmare,,293,90,383,1,384
Bhandara,,,Tumsar,60,,21,0,0,0,0,0,Charan Sovinda Waghmare,,291,151,442,0,442
Bhandara,,,Tumsar,60,,22,0,0,0,0,1,Charan Sovinda Waghmare,,401,116,517,1,518
Bhandara,,,Tumsar,60,,23,0,2,0,2,2,Charan Sovinda Waghmare,,583,337,920,2,922
Bhandara,,,Tumsar,60,,24,0,0,0,0,1,Charan Sovinda Waghmare,,529,276,805,1,806
Bhandara,,,Tumsar,60,,25,2,1,0,3,3,Charan Sovinda Waghmare,,380,203,583,3,586
Bhandara,,,Tumsar,60,,26,0,0,0,0,2,Charan Sovinda Waghmare,,368,147,515,2,517
Bhandara,,,Tumsar,60,,27,1,0,0,1,1,Charan Sovinda Waghmare,,302,232,534,1,535
Bhandara,,,Tumsar,60,,1,13,14,0,27,16,Charan Sovinda Waghmare,,2,76,78,16,94
Bhandara,,,Tumsar,60,,28,0,0,0,0,1,Charan Sovinda Waghmare,,431,159,590,1,591
Bhandara,,,Tumsar,60,,29,2,0,0,2,1,Charan Sovinda Waghmare,,328,264,592,1,593
Bhandara,,,Tumsar,60,,30,0,1,0,1,2,Charan Sovinda Waghmare,,196,148,344,2,346
Bhandara,,,Tumsar,60,,31,0,0,0,0,0,Charan Sovinda Waghmare,,337,252,589,0,589
Bhandara,,,Tumsar,60,,32,1,2,0,3,1,Charan Sovinda Waghmare,,298,237,535,1,536
Bhandara,,,Tumsar,60,,33,1,2,0,3,4,Charan Sovinda Waghmare,,391,267,658,4,662
Bhandara,,,Tumsar,60,,34,1,5,0,6,9,Charan Sovinda Waghmare,,300,387,687,9,696
Bhandara,,,Tumsar,60,,35,0,0,0,0,2,Charan Sovinda Waghmare,,180,145,325,2,327
Bhandara,,,Tumsar,60,,36,1,0,0,1,5,Charan Sovinda Waghmare,,248,423,671,5,676
Bhandara,,,Tumsar,60,,37,0,1,0,1,3,Charan Sovinda Waghmare,,176,301,477,3,480
Bhandara,,,Tumsar,60,,38,1,0,0,1,3,Charan Sovinda Waghmare,,180,334,514,3,517
Bhandara,,,Tumsar,60,,39,0,2,0,2,2,Charan Sovinda Waghmare,,374,319,693,2,695
Bhandara,,,Tumsar,60,,40,0,0,0,0,2,Charan Sovinda Waghmare,,311,265,576,2,578
Bhandara,,,Tumsar,60,,41,0,0,0,0,3,Charan Sovinda Waghmare,,283,135,418,3,421
Bhandara,,,Tumsar,60,,42,1,2,0,3,1,Charan Sovinda Waghmare,,215,247,462,1,463
Bhandara,,,Tumsar,60,,43,0,3,0,3,5,Charan Sovinda Waghmare,,278,336,614,5,619
Bhandara,,,Tumsar,60,,44,2,3,0,5,6,Charan Sovinda Waghmare,,172,296,468,6,474
Bhandara,,,Tumsar,60,,45,0,3,0,3,5,Charan Sovinda Waghmare,,354,334,688,5,693
Bhandara,,,Tumsar,60,,46,0,0,0,0,1,Charan Sovinda Waghmare,,330,384,714,1,715
Bhandara,,,Tumsar,60,,47,0,1,0,1,6,Charan Sovinda Waghmare,,413,337,750,6,756
Bhandara,,,Tumsar,60,,48,1,2,0,3,6,Charan Sovinda Waghmare,,462,408,870,6,876
Bhandara,,,Tumsar,60,,49,0,2,0,2,2,Charan Sovinda Waghmare,,319,302,621,2,623
Bhandara,,,Tumsar,60,,50,0,2,0,2,3,Charan Sovinda Waghmare,,587,213,800,3,803
Bhandara,,,Tumsar,60,,51,1,1,0,2,5,Charan Sovinda Waghmare,,335,353,688,5,693
Bhandara,,,Tumsar,60,,52,0,1,0,1,3,Charan Sovinda Waghmare,,359,378,737,3,740
Bhandara,,,Tumsar,60,,53,1,0,0,1,4,Charan Sovinda Waghmare,,298,309,607,4,611
Bhandara,,,Tumsar,60,,54,1,2,0,3,0,Charan Sovinda Waghmare,,303,86,389,0,389
Bhandara,,,Tumsar,60,,1,13,14,0,27,16,Charan Sovinda Waghmare,,2,76,78,16,94
Bhandara,,,Tumsar,60,,55,0,4,0,4,2,Charan Sovinda Waghmare,,299,152,451,2,453
Bhandara,,,Tumsar,60,,56,0,0,0,0,2,Charan Sovinda Waghmare,,265,254,519,2,521
Bhandara,,,Tumsar,60,,57,0,0,0,0,28,Charan Sovinda Waghmare,,480,386,866,28,894
Bhandara,,,Tumsar,60,,58,0,0,0,0,1,Charan Sovinda Waghmare,,407,353,760,1,761
Bhandara,,,Tumsar,60,,59,0,0,0,0,0,Charan Sovinda Waghmare,,75,171,246,0,246
Bhandara,,,Tumsar,60,,60,0,1,0,1,3,Charan Sovinda Waghmare,,455,152,607,3,610
Bhandara,,,Tumsar,60,,61,0,0,0,0,12,Charan Sovinda Waghmare,,542,294,836,12,848
Bhandara,,,Tumsar,60,,62,0,1,0,1,7,Charan Sovinda Waghmare,,302,256,558,7,565
Bhandara,,,Tumsar,60,,63,0,1,0,1,1,Charan Sovinda Waghmare,,512,182,694,1,695
Bhandara,,,Tumsar,60,,64,0,0,0,0,4,Charan Sovinda Waghmare,,453,213,666,4,670
Bhandara,,,Tumsar,60,,65,0,1,0,1,0,Charan Sovinda Waghmare,,292,307,599,0,599
Bhandara,,,Tumsar,60,,66,0,0,0,0,1,Charan Sovinda Waghmare,,434,223,657,1,658
Bhandara,,,Tumsar,60,,67,0,0,0,0,0,Charan Sovinda Waghmare,,246,265,511,0,511
Bhandara,,,Tumsar,60,,68,0,0,0,0,1,Charan Sovinda Waghmare,,146,398,544,1,545
Bhandara,,,Tumsar,60,,69,0,0,0,0,0,Charan Sovinda Waghmare,,110,269,379,0,379
Bhandara,,,Tumsar,60,,70,0,2,0,2,2,Charan Sovinda Waghmare,,525,531,1056,2,1058
Bhandara,,,Tumsar,60,,71,0,0,0,0,0,Charan Sovinda Waghmare,,193,229,422,0,422
Bhandara,,,Tumsar,60,,72,0,0,0,0,1,Charan Sovinda Waghmare,,377,523,900,1,901
Bhandara,,,Tumsar,60,,73,0,0,0,0,2,Charan Sovinda Waghmare,,381,497,878,2,880
Bhandara,,,Tumsar,60,,74,0,0,0,0,0,Charan Sovinda Waghmare,,349,536,885,0,885
Bhandara,,,Tumsar,60,,75,2,1,0,3,1,Charan Sovinda Waghmare,,423,344,767,1,768
Bhandara,,,Tumsar,60,,76,0,1,0,1,0,Charan Sovinda Waghmare,,511,315,826,0,826
Bhandara,,,Tumsar,60,,77,0,0,0,0,1,Charan Sovinda Waghmare,,404,300,704,1,705
Bhandara,,,Tumsar,60,,78,0,2,0,2,3,Charan Sovinda Waghmare,,482,290,772,3,775
Bhandara,,,Tumsar,60,,79,0,1,0,1,0,Charan Sovinda Waghmare,,288,347,635,0,635
Bhandara,,,Tumsar,60,,80,0,0,0,0,2,Charan Sovinda Waghmare,,261,363,624,2,626
Bhandara,,,Tumsar,60,,81,1,0,0,1,0,Charan Sovinda Waghmare,,354,336,690,0,690
Bhandara,,,Tumsar,60,,1,13,14,0,27,16,Charan Sovinda Waghmare,,2,76,78,16,94
Bhandara,,,Tumsar,60,,82,0,0,0,0,0,Charan Sovinda Waghmare,,405,281,686,0,686
Bhandara,,,Tumsar,60,,83,1,0,0,1,1,Charan Sovinda Waghmare,,535,543,1078,1,1079
Bhandara,,,Tumsar,60,,84,0,1,0,1,1,Charan Sovinda Waghmare,,198,244,442,1,443
Bhandara,,,Tumsar,60,,85,1,0,0,1,1,Charan Sovinda Waghmare,,311,401,712,1,713
Bhandara,,,Tumsar,60,,86,0,0,0,0,7,Charan Sovinda Waghmare,,553,229,782,7,789
Bhandara,,,Tumsar,60,,87,1,4,0,5,3,Charan Sovinda Waghmare,,443,364,807,3,810
Bhandara,,,Tumsar,60,,88,0,1,0,1,30,Charan Sovinda Waghmare,,705,255,960,30,990
Bhandara,,,Tumsar,60,,89,0,0,0,0,0,Charan Sovinda Waghmare,,97,143,240,0,240
Bhandara,,,Tumsar,60,,90,1,2,0,3,40,Charan Sovinda Waghmare,,393,336,729,40,769
Bhandara,,,Tumsar,60,,91,0,0,0,0,43,Charan Sovinda Waghmare,,302,283,585,43,628
Bhandara,,,Tumsar,60,,92,1,0,0,1,7,Charan Sovinda Waghmare,,290,246,536,7,543
Bhandara,,,Tumsar,60,,93,0,1,0,1,4,Charan Sovinda Waghmare,,330,195,525,4,529
Bhandara,,,Tumsar,60,,94,0,0,0,0,1,Charan Sovinda Waghmare,,226,240,466,1,467
Bhandara,,,Tumsar,60,,95,0,1,0,1,2,Charan Sovinda Waghmare,,242,448,690,2,692
Bhandara,,,Tumsar,60,,96,0,2,0,2,8,Charan Sovinda Waghmare,,371,330,701,8,709
Bhandara,,,Tumsar,60,,97,1,1,0,2,2,Charan Sovinda Waghmare,,394,472,866,2,868
Bhandara,,,Tumsar,60,,98,0,2,0,2,1,Charan Sovinda Waghmare,,322,498,820,1,821
Bhandara,,,Tumsar,60,,99,0,1,0,1,7,Charan Sovinda Waghmare,,314,351,665,7,672
Bhandara,,,Tumsar,60,,100,0,1,0,1,19,Charan Sovinda Waghmare,,481,369,850,19,869
Bhandara,,,Tumsar,60,,101,0,0,0,0,8,Charan Sovinda Waghmare,,394,259,653,8,661
Bhandara,,,Tumsar,60,,102,0,0,0,0,13,Charan Sovinda Waghmare,,414,325,739,13,752
Bhandara,,,Tumsar,60,,103,0,0,0,0,13,Charan Sovinda Waghmare,,456,337,793,13,806
Bhandara,,,Tumsar,60,,104,1,0,0,1,12,Charan Sovinda Waghmare,,415,306,721,12,733
Bhandara,,,Tumsar,60,,105,0,0,0,0,12,Charan Sovinda Waghmare,,423,310,733,12,745
Bhandara,,,Tumsar,60,,106,0,0,0,0,6,Charan Sovinda Waghmare,,442,327,769,6,775
Bhandara,,,Tumsar,60,,107,0,0,0,0,15,Charan Sovinda Waghmare,,314,306,620,15,635
Bhandara,,,Tumsar,60,,108,0,0,0,0,8,Charan Sovinda Waghmare,,389,307,696,8,704
Bhandara,,,Tumsar,60,,1,13,14,0,27,16,Charan Sovinda Waghmare,,2,76,78,16,94
Bhandara,,,Tumsar,60,,109,2,1,0,3,25,Charan Sovinda Waghmare,,394,319,713,25,738
Bhandara,,,Tumsar,60,,110,1,1,0,2,203,Charan Sovinda Waghmare,,351,357,708,203,911
Bhandara,,,Tumsar,60,,111,0,0,0,0,147,Charan Sovinda Waghmare,,346,344,690,147,837
Bhandara,,,Tumsar,60,,112,0,0,0,0,137,Charan Sovinda Waghmare,,403,302,705,137,842
Bhandara,,,Tumsar,60,,113,0,0,0,0,85,Charan Sovinda Waghmare,,371,367,738,85,823
Bhandara,,,Tumsar,60,,114,0,0,0,0,118,Charan Sovinda Waghmare,,240,268,508,118,626
Bhandara,,,Tumsar,60,,115,1,0,0,1,25,Charan Sovinda Waghmare,,481,383,864,25,889
Bhandara,,,Tumsar,60,,116,0,0,0,0,42,Charan Sovinda Waghmare,,230,325,555,42,597
Bhandara,,,Tumsar,60,,117,0,2,0,2,23,Charan Sovinda Waghmare,,493,298,791,23,814
Bhandara,,,Tumsar,60,,118,1,1,0,2,1,Charan Sovinda Waghmare,,300,260,560,1,561
Bhandara,,,Tumsar,60,,119,0,0,0,0,4,Charan Sovinda Waghmare,,291,251,542,4,546
Bhandara,,,Tumsar,60,,120,0,0,0,0,0,Charan Sovinda Waghmare,,474,291,765,0,765
Bhandara,,,Tumsar,60,,121,0,2,0,2,6,Charan Sovinda Waghmare,,439,316,755,6,761
Bhandara,,,Tumsar,60,,122,0,0,0,0,6,Charan Sovinda Waghmare,,624,308,932,6,938
Bhandara,,,Tumsar,60,,123,0,0,0,0,5,Charan Sovinda Waghmare,,585,321,906,5,911
Bhandara,,,Tumsar,60,,124,0,0,0,0,3,Charan Sovinda Waghmare,,452,300,752,3,755
Bhandara,,,Tumsar,60,,125,0,0,0,0,2,Charan Sovinda Waghmare,,413,351,764,2,766
Bhandara,,,Tumsar,60,,126,0,0,0,0,1,Charan Sovinda Waghmare,,459,331,790,1,791
Bhandara,,,Tumsar,60,,127,1,1,0,2,1,Charan Sovinda Waghmare,,289,424,713,1,714
Bhandara,,,Tumsar,60,,128,0,1,0,1,2,Charan Sovinda Waghmare,,395,455,850,2,852
Bhandara,,,Tumsar,60,,129,0,1,0,1,3,Charan Sovinda Waghmare,,308,361,669,3,672
Bhandara,,,Tumsar,60,,130,0,0,0,0,2,Charan Sovinda Waghmare,,430,473,903,2,905
Bhandara,,,Tumsar,60,,131,0,0,0,0,0,Charan Sovinda Waghmare,,328,298,626,0,626
Bhandara,,,Tumsar,60,,132,0,0,0,0,0,Charan Sovinda Waghmare,,269,403,672,0,672
Bhandara,,,Tumsar,60,,133,0,2,0,2,0,Charan Sovinda Waghmare,,135,317,452,0,452
Bhandara,,,Tumsar,60,,134,1,0,0,1,2,Charan Sovinda Waghmare,,342,338,680,2,682
Bhandara,,,Tumsar,60,,135,0,1,0,1,3,Charan Sovinda Waghmare,,300,352,652,3,655
Bhandara,,,Tumsar,60,,1,13,14,0,27,16,Charan Sovinda Waghmare,,2,76,78,16,94
Bhandara,,,Tumsar,60,,136,0,0,0,0,5,Charan Sovinda Waghmare,,303,549,852,5,857
Bhandara,,,Tumsar,60,,137,0,0,0,0,5,Charan Sovinda Waghmare,,278,415,693,5,698
Bhandara,,,Tumsar,60,,138,0,0,0,0,0,Charan Sovinda Waghmare,,284,456,740,0,740
Bhandara,,,Tumsar,60,,139,0,0,0,0,4,Charan Sovinda Waghmare,,376,508,884,4,888
Bhandara,,,Tumsar,60,,140,0,2,0,2,1,Charan Sovinda Waghmare,,368,540,908,1,909
Bhandara,,,Tumsar,60,,141,0,1,0,1,2,Charan Sovinda Waghmare,,372,490,862,2,864
Bhandara,,,Tumsar,60,,142,0,1,0,1,0,Charan Sovinda Waghmare,,427,378,805,0,805
Bhandara,,,Tumsar,60,,143,0,0,0,0,2,Charan Sovinda Waghmare,,395,529,924,2,926
Bhandara,,,Tumsar,60,,144,0,1,0,1,0,Charan Sovinda Waghmare,,363,437,800,0,800
Bhandara,,,Tumsar,60,,145,0,0,0,0,0,Charan Sovinda Waghmare,,277,388,665,0,665
Bhandara,,,Tumsar,60,,146,0,0,0,0,0,Charan Sovinda Waghmare,,364,506,870,0,870
Bhandara,,,Tumsar,60,,147,0,0,0,0,0,Charan Sovinda Waghmare,,463,433,896,0,896
Bhandara,,,Tumsar,60,,148,0,1,0,1,0,Charan Sovinda Waghmare,,221,419,640,0,640
Bhandara,,,Tumsar,60,,149,0,0,0,0,0,Charan Sovinda Waghmare,,359,435,794,0,794
Bhandara,,,Tumsar,60,,150,1,0,0,1,3,Charan Sovinda Waghmare,,559,385,944,3,947
Bhandara,,,Tumsar,60,,151,0,0,0,0,1,Charan Sovinda Waghmare,,422,486,908,1,909
Bhandara,,,Tumsar,60,,152,0,0,0,0,2,Charan Sovinda Waghmare,,423,322,745,2,747
Bhandara,,,Tumsar,60,,153,0,0,0,0,2,Charan Sovinda Waghmare,,437,468,905,2,907
Bhandara,,,Tumsar,60,,154,1,0,0,1,10,Charan Sovinda Waghmare,,321,559,880,10,890
Bhandara,,,Tumsar,60,,155,0,0,0,0,6,Charan Sovinda Waghmare,,345,525,870,6,876
Bhandara,,,Tumsar,60,,156,0,1,0,1,18,Charan Sovinda Waghmare,,363,548,911,18,929
Bhandara,,,Tumsar,60,,157,0,0,0,0,7,Charan Sovinda Waghmare,,316,346,662,7,669
Bhandara,,,Tumsar,60,,158,0,0,0,0,7,Charan Sovinda Waghmare,,329,350,679,7,686
Bhandara,,,Tumsar,60,,159,0,1,0,1,26,Charan Sovinda Waghmare,,374,384,758,26,784
Bhandara,,,Tumsar,60,,160,1,0,0,1,88,Charan Sovinda Waghmare,,345,273,618,88,706
Bhandara,,,Tumsar,60,,161,0,0,0,0,20,Charan Sovinda Waghmare,,348,315,663,20,683
Bhandara,,,Tumsar,60,,162,0,1,0,1,19,Charan Sovinda Waghmare,,365,380,745,19,764
Bhandara,,,Tumsar,60,,1,13,14,0,27,16,Charan Sovinda Waghmare,,2,76,78,16,94
Bhandara,,,Tumsar,60,,163,1,0,0,1,12,Charan Sovinda Waghmare,,578,408,986,12,998
Bhandara,,,Tumsar,60,,164,1,0,0,1,13,Charan Sovinda Waghmare,,396,340,736,13,749
Bhandara,,,Tumsar,60,,165,0,1,0,1,5,Charan Sovinda Waghmare,,450,405,855,5,860
Bhandara,,,Tumsar,60,,166,1,2,0,3,5,Charan Sovinda Waghmare,,362,541,903,5,908
Bhandara,,,Tumsar,60,,167,2,1,0,3,1,Charan Sovinda Waghmare,,300,459,759,1,760
Bhandara,,,Tumsar,60,,168,0,0,0,0,2,Charan Sovinda Waghmare,,162,253,415,2,417
Bhandara,,,Tumsar,60,,169,0,0,0,0,0,Charan Sovinda Waghmare,,507,449,956,0,956
Bhandara,,,Tumsar,60,,170,0,1,0,1,1,Charan Sovinda Waghmare,,203,391,594,1,595
Bhandara,,,Tumsar,60,,171,0,0,0,0,0,Charan Sovinda Waghmare,,284,421,705,0,705
Bhandara,,,Tumsar,60,,172,1,0,0,1,4,Charan Sovinda Waghmare,,428,338,766,4,770
Bhandara,,,Tumsar,60,,173,0,0,0,0,0,Charan Sovinda Waghmare,,427,364,791,0,791
Bhandara,,,Tumsar,60,,174,0,0,0,0,5,Charan Sovinda Waghmare,,377,469,846,5,851
Bhandara,,,Tumsar,60,,175,0,1,0,1,1,Charan Sovinda Waghmare,,484,467,951,1,952
Bhandara,,,Tumsar,60,,176,0,0,0,0,1,Charan Sovinda Waghmare,,360,349,709,1,710
Bhandara,,,Tumsar,60,,177,0,0,0,0,0,Charan Sovinda Waghmare,,366,343,709,0,709
Bhandara,,,Tumsar,60,,178,0,0,0,0,3,Charan Sovinda Waghmare,,422,423,845,3,848
Bhandara,,,Tumsar,60,,179,0,0,0,0,0,Charan Sovinda Waghmare,,404,288,692,0,692
Bhandara,,,Tumsar,60,,180,0,0,0,0,1,Charan Sovinda Waghmare,,413,396,809,1,810
Bhandara,,,Tumsar,60,,181,0,0,0,0,0,Charan Sovinda Waghmare,,381,349,730,0,730
Bhandara,,,Tumsar,60,,182,0,0,0,0,1,Charan Sovinda Waghmare,,497,562,1059,1,1060
Bhandara,,,Tumsar,60,,183,1,2,0,3,6,Charan Sovinda Waghmare,,581,496,1077,6,1083
Bhandara,,,Tumsar,60,,184,2,3,0,5,4,Charan Sovinda Waghmare,,660,409,1069,4,1073
Bhandara,,,Tumsar,60,,185,0,0,0,0,0,Charan Sovinda Waghmare,,371,322,693,0,693
Bhandara,,,Tumsar,60,,186,0,0,0,0,0,Charan Sovinda Waghmare,,291,304,595,0,595
Bhandara,,,Tumsar,60,,187,1,0,0,1,4,Charan Sovinda Waghmare,,245,326,571,4,575
Bhandara,,,Tumsar,60,,188,0,0,0,0,0,Charan Sovinda Waghmare,,259,320,579,0,579
Bhandara,,,Tumsar,60,,189,1,2,0,3,0,Charan Sovinda Waghmare,,322,357,679,0,679
Bhandara,,,Tumsar,60,,1,13,14,0,27,16,Charan Sovinda Waghmare,,2,76,78,16,94
Bhandara,,,Tumsar,60,,190,0,0,0,0,0,Charan Sovinda Waghmare,,312,380,692,0,692
Bhandara,,,Tumsar,60,,191,0,0,0,0,5,Charan Sovinda Waghmare,,284,327,611,5,616
Bhandara,,,Tumsar,60,,192,0,1,0,1,4,Charan Sovinda Waghmare,,301,321,622,4,626
Bhandara,,,Tumsar,60,,193,0,0,0,0,8,Charan Sovinda Waghmare,,348,328,676,8,684
Bhandara,,,Tumsar,60,,194,0,0,0,0,0,Charan Sovinda Waghmare,,208,405,613,0,613
Bhandara,,,Tumsar,60,,195,0,1,0,1,4,Charan Sovinda Waghmare,,249,341,590,4,594
Bhandara,,,Tumsar,60,,196,1,3,0,4,5,Charan Sovinda Waghmare,,379,374,753,5,758
Bhandara,,,Tumsar,60,,197,0,0,0,0,0,Charan Sovinda Waghmare,,533,387,920,0,920
Bhandara,,,Tumsar,60,,198,0,0,0,0,0,Charan Sovinda Waghmare,,296,312,608,0,608
Bhandara,,,Tumsar,60,,199,0,0,0,0,2,Charan Sovinda Waghmare,,285,288,573,2,575
Bhandara,,,Tumsar,60,,200,0,1,0,1,0,Charan Sovinda Waghmare,,294,331,625,0,625
Bhandara,,,Tumsar,60,,201,0,1,0,1,0,Charan Sovinda Waghmare,,448,442,890,0,890
Bhandara,,,Tumsar,60,,202,1,0,0,1,2,Charan Sovinda Waghmare,,206,474,680,2,682
Bhandara,,,Tumsar,60,,203,1,0,0,1,0,Charan Sovinda Waghmare,,219,488,707,0,707
Bhandara,,,Tumsar,60,,204,0,0,0,0,0,Charan Sovinda Waghmare,,419,388,807,0,807
Bhandara,,,Tumsar,60,,205,0,0,0,0,2,Charan Sovinda Waghmare,,297,344,641,2,643
Bhandara,,,Tumsar,60,,206,0,0,0,0,0,Charan Sovinda Waghmare,,310,304,614,0,614
Bhandara,,,Tumsar,60,,207,0,0,0,0,1,Charan Sovinda Waghmare,,296,316,612,1,613
Bhandara,,,Tumsar,60,,208,0,0,0,0,2,Charan Sovinda Waghmare,,472,530,1002,2,1004
Bhandara,,,Tumsar,60,,209,1,0,0,1,4,Charan Sovinda Waghmare,,322,581,903,4,907
Bhandara,,,Tumsar,60,,210,0,0,0,0,2,Charan Sovinda Waghmare,,465,424,889,2,891
Bhandara,,,Tumsar,60,,211,0,0,0,0,2,Charan Sovinda Waghmare,,362,353,715,2,717
Bhandara,,,Tumsar,60,,212,0,0,0,0,0,Charan Sovinda Waghmare,,482,409,891,0,891
Bhandara,,,Tumsar,60,,213,0,1,0,1,0,Charan Sovinda Waghmare,,413,384,797,0,797
Bhandara,,,Tumsar,60,,214,0,0,0,0,0,Charan Sovinda Waghmare,,415,369,784,0,784
Bhandara,,,Tumsar,60,,215,0,0,0,0,0,Charan Sovinda Waghmare,,501,336,837,0,837
Bhandara,,,Tumsar,60,,216,0,0,0,0,2,Charan Sovinda Waghmare,,231,352,583,2,585
Bhandara,,,Tumsar,60,,1,13,14,0,27,16,Charan Sovinda Waghmare,,2,76,78,16,94
Bhandara,,,Tumsar,60,,217,0,0,0,0,1,Charan Sovinda Waghmare,,325,337,662,1,663
Bhandara,,,Tumsar,60,,218,1,2,0,3,6,Charan Sovinda Waghmare,,349,345,694,6,700
Bhandara,,,Tumsar,60,,219,0,1,0,1,0,Charan Sovinda Waghmare,,699,571,1270,0,1270
Bhandara,,,Tumsar,60,,220,0,0,0,0,1,Charan Sovinda Waghmare,,583,549,1132,1,1133
Bhandara,,,Tumsar,60,,221,1,2,0,3,1,Charan Sovinda Waghmare,,434,373,807,1,808
Bhandara,,,Tumsar,60,,222,0,0,0,0,2,Charan Sovinda Waghmare,,266,471,737,2,739
Bhandara,,,Tumsar,60,,223,0,0,0,0,0,Charan Sovinda Waghmare,,483,632,1115,0,1115
Bhandara,,,Tumsar,60,,224,1,1,0,2,1,Charan Sovinda Waghmare,,491,548,1039,1,1040
Bhandara,,,Tumsar,60,,225,0,0,0,0,1,Charan Sovinda Waghmare,,275,603,878,1,879
Bhandara,,,Tumsar,60,,226,0,0,0,0,1,Charan Sovinda Waghmare,,319,536,855,1,856
Bhandara,,,Tumsar,60,,227,0,1,0,1,0,Charan Sovinda Waghmare,,290,469,759,0,759
Bhandara,,,Tumsar,60,,228,2,0,0,2,2,Charan Sovinda Waghmare,,380,592,972,2,974
Bhandara,,,Tumsar,60,,229,0,0,0,0,0,Charan Sovinda Waghmare,,273,449,722,0,722
Bhandara,,,Tumsar,60,,230,0,0,0,0,1,Charan Sovinda Waghmare,,377,533,910,1,911
Bhandara,,,Tumsar,60,,231,0,0,0,0,0,Charan Sovinda Waghmare,,406,490,896,0,896
Bhandara,,,Tumsar,60,,232,0,1,0,1,1,Charan Sovinda Waghmare,,532,644,1176,1,1177
Bhandara,,,Tumsar,60,,233,0,0,0,0,2,Charan Sovinda Waghmare,,405,620,1025,2,1027
Bhandara,,,Tumsar,60,,234,0,0,0,0,0,Charan Sovinda Waghmare,,497,593,1090,0,1090
Bhandara,,,Tumsar,60,,235,0,4,0,4,2,Charan Sovinda Waghmare,,535,634,1169,2,1171
Bhandara,,,Tumsar,60,,236,1,1,0,2,0,Charan Sovinda Waghmare,,456,479,935,0,935
Bhandara,,,Tumsar,60,,237,0,0,0,0,2,Charan Sovinda Waghmare,,340,551,891,2,893
Bhandara,,,Tumsar,60,,238,0,1,0,1,1,Charan Sovinda Waghmare,,274,445,719,1,720
Bhandara,,,Tumsar,60,,239,0,0,0,0,3,Charan Sovinda Waghmare,,603,574,1177,3,1180
Bhandara,,,Tumsar,60,,240,0,0,0,0,1,Charan Sovinda Waghmare,,359,517,876,1,877
Bhandara,,,Tumsar,60,,241,0,0,0,0,0,Charan Sovinda Waghmare,,227,434,661,0,661
Bhandara,,,Tumsar,60,,242,0,0,0,0,3,Charan Sovinda Waghmare,,377,320,697,3,700
Bhandara,,,Tumsar,60,,243,2,2,0,4,2,Charan Sovinda Waghmare,,460,409,869,2,871
Bhandara,,,Tumsar,60,,1,13,14,0,27,16,Charan Sovinda Waghmare,,2,76,78,16,94
Bhandara,,,Tumsar,60,,244,0,1,0,1,2,Charan Sovinda Waghmare,,404,432,836,2,838
Bhandara,,,Tumsar,60,,245,0,0,0,0,2,Charan Sovinda Waghmare,,435,642,1077,2,1079
Bhandara,,,Tumsar,60,,246,0,0,0,0,1,Charan Sovinda Waghmare,,275,570,845,1,846
Bhandara,,,Tumsar,60,,247,0,2,0,2,3,Charan Sovinda Waghmare,,288,565,853,3,856
Bhandara,,,Tumsar,60,,248,0,0,0,0,2,Charan Sovinda Waghmare,,245,456,701,2,703
Bhandara,,,Tumsar,60,,249,1,1,0,2,4,Charan Sovinda Waghmare,,687,485,1172,4,1176
Bhandara,,,Tumsar,60,,250,0,0,0,0,0,Charan Sovinda Waghmare,,338,403,741,0,741
Bhandara,,,Tumsar,60,,251,0,0,0,0,0,Charan Sovinda Waghmare,,294,403,697,0,697
Bhandara,,,Tumsar,60,,252,0,0,0,0,2,Charan Sovinda Waghmare,,431,506,937,2,939
Bhandara,,,Tumsar,60,,253,0,1,0,1,5,Charan Sovinda Waghmare,,469,547,1016,5,1021
Bhandara,,,Tumsar,60,,254,0,0,0,0,3,Charan Sovinda Waghmare,,580,481,1061,3,1064
Bhandara,,,Tumsar,60,,255,0,0,0,0,2,Charan Sovinda Waghmare,,473,390,863,2,865
Bhandara,,,Tumsar,60,,256,0,0,0,0,2,Charan Sovinda Waghmare,,572,457,1029,2,1031
Bhandara,,,Tumsar,60,,257,0,0,0,0,2,Charan Sovinda Waghmare,,363,447,810,2,812
Bhandara,,,Tumsar,60,,258,0,1,0,1,3,Charan Sovinda Waghmare,,368,534,902,3,905
Bhandara,,,Tumsar,60,,259,0,0,0,0,5,Charan Sovinda Waghmare,,381,550,931,5,936
Bhandara,,,Tumsar,60,,260,0,0,0,0,1,Charan Sovinda Waghmare,,486,483,969,1,970
Bhandara,,,Tumsar,60,,261,0,4,0,4,0,Charan Sovinda Waghmare,,632,434,1066,0,1066
Bhandara,,,Tumsar,60,,262,0,0,0,0,1,Charan Sovinda Waghmare,,408,692,1100,1,1101
Bhandara,,,Tumsar,60,,263,2,0,0,2,1,Charan Sovinda Waghmare,,530,527,1057,1,1058
Bhandara,,,Tumsar,60,,264,2,2,0,4,5,Charan Sovinda Waghmare,,552,496,1048,5,1053
Bhandara,,,Tumsar,60,,265,2,5,0,7,1,Charan Sovinda Waghmare,,472,490,962,1,963
Bhandara,,,Tumsar,60,,266,4,1,0,5,4,Charan Sovinda Waghmare,,492,497,989,4,993
Bhandara,,,Tumsar,60,,267,0,1,0,1,0,Charan Sovinda Waghmare,,287,419,706,0,706
Bhandara,,,Tumsar,60,,268,1,0,0,1,1,Charan Sovinda Waghmare,,335,416,751,1,752
Bhandara,,,Tumsar,60,,269,3,4,0,7,3,Charan Sovinda Waghmare,,476,530,1006,3,1009
Bhandara,,,Tumsar,60,,270,1,15,0,16,3,Charan Sovinda Waghmare,,458,544,1002,3,1005
Bhandara,,,Tumsar,60,,1,13,14,0,27,16,Charan Sovinda Waghmare,,2,76,78,16,94
Bhandara,,,Tumsar,60,,271,0,9,0,9,3,Charan Sovinda Waghmare,,469,513,982,3,985
Bhandara,,,Tumsar,60,,272,0,6,0,6,5,Charan Sovinda Waghmare,,451,479,930,5,935
Bhandara,,,Tumsar,60,,273,1,0,0,1,0,Charan Sovinda Waghmare,,343,471,814,0,814
Bhandara,,,Tumsar,60,,274,0,1,0,1,1,Charan Sovinda Waghmare,,442,484,926,1,927
Bhandara,,,Tumsar,60,,275,0,0,0,0,0,Charan Sovinda Waghmare,,380,460,840,0,840
Bhandara,,,Tumsar,60,,276,0,3,0,3,1,Charan Sovinda Waghmare,,522,642,1164,1,1165
Bhandara,,,Tumsar,60,,277,0,0,0,0,0,Charan Sovinda Waghmare,,260,453,713,0,713
Bhandara,,,Tumsar,60,,278,1,0,0,1,4,Charan Sovinda Waghmare,,392,834,1226,4,1230
Bhandara,,,Tumsar,60,,279,0,0,0,0,3,Charan Sovinda Waghmare,,422,672,1094,3,1097
Bhandara,,,Tumsar,60,,280,0,0,0,0,0,Charan Sovinda Waghmare,,357,520,877,0,877
Bhandara,,,Tumsar,60,,281,0,1,0,1,2,Charan Sovinda Waghmare,,435,533,968,2,970
Bhandara,,,Tumsar,60,,282,3,2,0,5,1,Charan Sovinda Waghmare,,699,667,1366,1,1367
Bhandara,,,Tumsar,60,,283,0,1,0,1,2,Charan Sovinda Waghmare,,473,546,1019,2,1021
Bhandara,,,Tumsar,60,,284,1,3,0,4,5,Charan Sovinda Waghmare,,592,537,1129,5,1134
Bhandara,,,Tumsar,60,,285,0,1,0,1,4,Charan Sovinda Waghmare,,461,594,1055,4,1059
Bhandara,,,Tumsar,60,,286,1,2,0,3,1,Charan Sovinda Waghmare,,366,613,979,1,980
Bhandara,,,Tumsar,60,,287,1,0,0,1,0,Charan Sovinda Waghmare,,466,498,964,0,964
Bhandara,,,Tumsar,60,,288,0,1,0,1,0,Charan Sovinda Waghmare,,481,520,1001,0,1001
Bhandara,,,Tumsar,60,,289,0,2,0,2,2,Charan Sovinda Waghmare,,290,719,1009,2,1011
Bhandara,,,Tumsar,60,,290,0,0,0,0,1,Charan Sovinda Waghmare,,395,490,885,1,886
Bhandara,,,Tumsar,60,,291,0,0,0,0,0,Charan Sovinda Waghmare,,336,525,861,0,861
Bhandara,,,Tumsar,60,,292,1,0,0,1,1,Charan Sovinda Waghmare,,381,502,883,1,884
Bhandara,,,Tumsar,60,,293,0,0,0,0,2,Charan Sovinda Waghmare,,227,471,698,2,700
Bhandara,,,Tumsar,60,,294,0,0,0,0,1,Charan Sovinda Waghmare,,306,450,756,1,757
Bhandara,,,Tumsar,60,,295,0,0,0,0,0,Charan Sovinda Waghmare,,453,535,988,0,988
Bhandara,,,Tumsar,60,,296,0,0,0,0,1,Charan Sovinda Waghmare,,300,433,733,1,734
Bhandara,,,Tumsar,60,,297,0,0,0,0,0,Charan Sovinda Waghmare,,469,522,991,0,991
Bhandara,,,Tumsar,60,,1,13,14,0,27,16,Charan Sovinda Waghmare,,2,76,78,16,94
Bhandara,,,Tumsar,60,,298,0,0,0,0,1,Charan Sovinda Waghmare,,505,534,1039,1,1040
Bhandara,,,Tumsar,60,,299,0,0,0,0,0,Charan Sovinda Waghmare,,480,554,1034,0,1034
Bhandara,,,Tumsar,60,,300,0,0,0,0,2,Charan Sovinda Waghmare,,541,620,1161,2,1163
Bhandara,,,Tumsar,60,,301,0,0,0,0,0,Charan Sovinda Waghmare,,450,623,1073,0,1073
Bhandara,,,Tumsar,60,,302,0,0,0,0,4,Charan Sovinda Waghmare,,510,624,1134,4,1138
Bhandara,,,Tumsar,60,,303,0,1,0,1,9,Charan Sovinda Waghmare,,568,720,1288,9,1297
Bhandara,,,Tumsar,60,,304,0,1,0,1,2,Charan Sovinda Waghmare,,188,533,721,2,723
Bhandara,,,Tumsar,60,,305,0,0,0,0,0,Charan Sovinda Waghmare,,106,392,498,0,498
Bhandara,,,Tumsar,60,,306,1,0,0,1,1,Charan Sovinda Waghmare,,614,511,1125,1,1126
Bhandara,,,Tumsar,60,,307,0,2,0,2,3,Charan Sovinda Waghmare,,523,483,1006,3,1009
Bhandara,,,Tumsar,60,,308,0,0,0,0,1,Charan Sovinda Waghmare,,562,535,1097,1,1098
Bhandara,,,Tumsar,60,,309,0,0,0,0,0,Charan Sovinda Waghmare,,567,524,1091,0,1091
Bhandara,,,Tumsar,60,,310,0,0,0,0,2,Charan Sovinda Waghmare,,512,413,925,2,927
Bhandara,,,Tumsar,60,,311,0,0,0,0,0,Charan Sovinda Waghmare,,389,410,799,0,799
Bhandara,,,Tumsar,60,,312,0,0,0,0,0,Charan Sovinda Waghmare,,473,549,1022,0,1022
Bhandara,,,Tumsar,60,,313,0,0,0,0,2,Charan Sovinda Waghmare,,513,683,1196,2,1198
Bhandara,,,Tumsar,60,,314,1,0,0,1,0,Charan Sovinda Waghmare,,440,531,971,0,971
Bhandara,,,Tumsar,60,,315,0,0,0,0,0,Charan Sovinda Waghmare,,551,513,1064,0,1064
Bhandara,,,Tumsar,60,,316,0,0,0,0,3,Charan Sovinda Waghmare,,421,531,952,3,955
Bhandara,,,Tumsar,60,,317,0,0,0,0,0,Charan Sovinda Waghmare,,468,538,1006,0,1006
Bhandara,,,Tumsar,60,,318,0,1,0,1,0,Charan Sovinda Waghmare,,191,428,619,0,619
Bhandara,,,Tumsar,60,,319,0,0,0,0,1,Charan Sovinda Waghmare,,299,464,763,1,764
Bhandara,,,Tumsar,60,,320,0,0,0,0,1,Charan Sovinda Waghmare,,524,382,906,1,907
Bhandara,,,Tumsar,60,,321,0,0,0,0,0,Charan Sovinda Waghmare,,204,402,606,0,606
Bhandara,,,Tumsar,60,,322,0,0,0,0,0,Charan Sovinda Waghmare,,292,574,866,0,866
Bhandara,,,Tumsar,60,,323,0,0,0,0,4,Charan Sovinda Waghmare,,244,616,860,4,864
Bhandara,,,Tumsar,60,,324,0,0,0,0,2,Charan Sovinda Waghmare,,324,551,875,2,877
Bhandara,,,Tumsar,60,,1,13,14,0,27,16,Charan Sovinda Waghmare,,2,76,78,16,94
Bhandara,,,Tumsar,60,,325,1,3,0,4,3,Charan Sovinda Waghmare,,614,711,1325,3,1328
Bhandara,,,Tumsar,60,,326,0,0,0,0,0,Charan Sovinda Waghmare,,64,404,468,0,468
Bhandara,,,Tumsar,60,,327,0,0,0,0,3,Charan Sovinda Waghmare,,154,500,654,3,657
Bhandara,,,Tumsar,60,,328,0,0,0,0,0,Charan Sovinda Waghmare,,411,568,979,0,979
Bhandara,,,Tumsar,60,,329,0,0,0,0,2,Charan Sovinda Waghmare,,424,595,1019,2,1021
Bhandara,,,Tumsar,60,,330,0,0,0,0,2,Charan Sovinda Waghmare,,425,527,952,2,954
Bhandara,,,Tumsar,60,,331,0,0,0,0,0,Charan Sovinda Waghmare,,443,562,1005,0,1005
Bhandara,,,Tumsar,60,,332,0,2,0,2,3,Charan Sovinda Waghmare,,293,639,932,3,935
Bhandara,,,Tumsar,60,,333,1,0,0,1,1,Charan Sovinda Waghmare,,517,517,1034,1,1035
Bhandara,,,Tumsar,60,,334,0,1,0,1,1,Charan Sovinda Waghmare,,416,555,971,1,972
Bhandara,,,Tumsar,60,,335,1,0,0,1,1,Charan Sovinda Waghmare,,364,566,930,1,931
Bhandara,,,Tumsar,60,,336,1,0,0,1,0,Charan Sovinda Waghmare,,644,492,1136,0,1136
Bhandara,,,Tumsar,60,,337,1,0,0,1,0,Charan Sovinda Waghmare,,369,420,789,0,789
Bhandara,,,Tumsar,60,,338,1,1,0,2,4,Charan Sovinda Waghmare,,414,751,1165,4,1169
Bhandara,,,Tumsar,60,,339,0,0,0,0,0,Charan Sovinda Waghmare,,465,717,1182,0,1182
Bhandara,,,Tumsar,60,,340,0,0,0,0,0,Charan Sovinda Waghmare,,459,660,1119,0,1119
Bhandara,,,Tumsar,60,,341,1,0,0,1,4,Charan Sovinda Waghmare,,520,611,1131,4,1135
Bhandara,,,Tumsar,60,,342,0,2,0,2,1,Charan Sovinda Waghmare,,657,626,1283,1,1284
Bhandara,,,Tumsar,60,,343,0,0,0,0,1,Charan Sovinda Waghmare,,313,563,876,1,877
Bhandara,,,Tumsar,60,,344,0,1,0,1,2,Charan Sovinda Waghmare,,470,714,1184,2,1186
Bhandara,,,Tumsar,60,,345,0,0,0,0,0,Charan Sovinda Waghmare,,258,599,857,0,857
Bhandara,,,Tumsar,60,,346,0,0,0,0,3,Charan Sovinda Waghmare,,194,606,800,3,803
Bhandara,,,Tumsar,60,,347,0,0,0,0,1,Charan Sovinda Waghmare,,426,642,1068,1,1069
Bhandara,,,Tumsar,60,,348,0,1,0,1,2,Charan Sovinda Waghmare,,470,609,1079,2,1081
Bhandara,,,Tumsar,60,,349,0,0,0,0,0,Charan Sovinda Waghmare,,560,549,1109,0,1109
Bhandara,,,Tumsar,60,,350,0,0,0,0,0,Charan Sovinda Waghmare,,331,607,938,0,938
Bhandara,,,Tumsar,60,,351,0,0,0,0,0,Charan Sovinda Waghmare,,224,630,854,0,854
Bhandara,,,Tumsar,60,,1,13,14,0,27,16,Charan Sovinda Waghmare,,2,76,78,16,94
Bhandara,,,Tumsar,60,,352,0,0,0,0,0,Charan Sovinda Waghmare,,152,439,591,0,591
Bhandara,,,Tumsar,60,,353,0,0,0,0,0,Charan Sovinda Waghmare,,248,591,839,0,839
TOTAL,,,,,,,284,446,0,730,2104,,,134760,145712,280472,2104,282576
